leander perez	C
bennett champ clark	Start
conservatives concerned about the death penalty	Start
philippa schuyler	Start
charles evers	GA
jon huntsman presidential campaign, 2012	FA
alex clark	Stub
john allen wilcox	Start
stuart butler	C
anton kraabel	Start
pete sessions	C
douglas bruce	GA
republican party presidential primaries, 1940	B
pamela geller	GA
college republicans	GA
philip breitmeyer	Start
charles lindbergh	FA
tommy thompson presidential campaign, 2008	FA
henry bonilla	C
fred baser	Stub
oklahoma republican party	GA
dana dow	Stub
tim hugo	C
david harmer	C
kittredge haskins	Start
janet trujillo	Stub
leslie donovan	Start
andy martin	GA
dennis frederickson	C
wide awake parade	Stub
johnny isakson	B
john huppenthal	C
fred grandy	C
lisa torraco	Start
gail lavielle	Start
daniel zolnikov	Stub
sean eberhart	Stub
elisha baxter	Start
randal quarles	C
robert pleasant trippe	Start
ebenezer blakely	Start
1924 republican national convention	C
tom grady	Stub
1904 republican national convention	C
aaron osmond	C
alex castellanos	GA
michael aylesworth	C
gilman marston	Start
jesse fuller mcdonald	Start
lisa graham keegan	GA
bill beeny	C
thomas cunningham cochran	Start
lamar alexander	B
heather whitestone	C
robert bauman	C
robert benvenuti	Stub
thomas ravenel	C
william wallace atterbury	C
dick thompson morgan	Start
ed lindsey	C
moses mcclean	Stub
dana andrews	C
jim courter	Start
john dendahl	Start
jim justice	C
john linder	C
huck pac	Stub
eric cantor	B
donnie berthiaume	Stub
william aldrich	Stub
tim walberg	C
chris gerlach	GA
erik fresen	Start
maria weston chapman	C
howard buffett	C
brad drake	Start
jerry dockham	Start
harrison thyng	B
barbara cegavske	Start
ben nighthorse campbell	C
robert lynn hogg	Start
jeffrey spiegelman	Stub
walter gooley	Stub
pedro tenorio	Start
algernon paddock	Start
welcome to obamaland	Start
kirk lippold	C
joseph mohorovic	Stub
jeff kropf	Start
libertarian republican	GA
miles ferry	Stub
mike pence	GA
john kronmiller	Stub
fletcher thompson	C
john cabello	Stub
ogden driskill	Stub
glen bradley	C
william carlile arnold	Stub
jeff dewit	C
david dewhurst	GA
cleta mitchell	C
valde garcia	Stub
esther buckley	C
edwin meese	GA
anne stevens	Stub
wayne harper	C
percy walker	Stub
wesley powell	Stub
glenn robert davis	C
eddie rickenbacker	GA
ron justice	Stub
jim bolin	Start
patrick ruffini	C
bethuel kitchen	C
haskel ayers	Stub
tony cornish	Start
appeal of the independent democrats	Start
dennis algiere	C
tim babcock	Start
john cavaletto	Start
linda mcmahon	GA
robert butera	Stub
ken cuccinelli	GA
william swain lee	C
jay batt	Start
jon bumstead	Stub
eben martin	Start
1900 republican national convention	C
the american magazine	Start
richard lloyd jones	C
jerry moran	C
styles bridges	C
politte elvins	Stub
mike pantelides	C
andrew sloan	Stub
john mellen thurston	Start
republican conference of the united states house of representatives	Stub
lanny fite	Start
mike milburn	Stub
stuart hunt	Stub
andy mckenzie	Stub
dewayne burns	Start
rusty farley	Stub
elliott abrams	C
hance cleland	Stub
kirsten hughes	Start
morgan griffith	C
maurice britt	C
lewis hanback	Start
mark batinick	Stub
jim decesare	Start
gerald burton winrod	C
connie morella	C
lucien anderson	Start
scott brister	Start
ray shamie	Start
ryan quarles	C
the heritage foundation	FA
michael karickhoff	Stub
phillip hinkle	C
karen awana	Start
john raese	C
tufele liamatua	C
robin weisz	Stub
harvey hancock	Start
phil jensen	C
andrew honeycutt	Stub
republican national committee chairmanship election, 2011	C
danny bubp	C
denise bode	C
isaac roberts hawkins	Start
michael chertoff	C
john kimball	Start
brent littlefield	Start
republican liberty caucus	C
john wallen	GA
john pickler	Start
sadie hurst	Stub
hollister jackson	C
andrew jackson hamilton	C
managerial state	C
mike hawker	Start
frank hanford	Stub
james frank	C
belden bly	Start
pat comfort	Stub
mike edmonson	C
nicholas asselta	Start
ray wolfe	Stub
morley griswold	Stub
leon bramlett	C
brandon hixon	Stub
allan bense	Start
bud cummins	C
washington irving warrey	Start
lee mckinley	Start
jim hendren	Start
eileen melvin	Start
otto krueger	Start
frederick heiskell	B
isaac clements	Stub
john dalzell	C
david cuddy	Start
laura bradford	C
jason atkinson	C
brock greenfield	C
charles germman burton	Stub
lyman enos knapp	C
george folsom	Start
walter moses burton	Stub
john dimaio	C
lee hawkins	Start
chris devaney	Start
pam peterson	Start
rick sheehy	Start
marvin kleeb	Stub
anna escobedo cabral	C
john albers	C
herman goldner	GA
arkansas project	B
randy terrill	Start
clay aurand	Start
lance harvell	Stub
robert anderst	Stub
restoring courage tour	C
mike ritze	Stub
list of 1994 contract with america signers	Start
john long routt	Start
richard stephen ritchie	C
joel fry	Stub
james david santini	Start
martin alonzo haynes	Start
paul bussman	Start
michelle fischbach	Start
george blumberg	Stub
charles lollar	C
george wallace presidential campaign, 1968	C
harris blake	Stub
susan farmer	Stub
luther bradish	Start
bobby jindal presidential campaign, 2016	B
ruthann aron	C
elizabeth coulson	Stub
tasker oddie	Start
gordon hendrick	Stub
alexander butterfield	GA
mae nolan	Start
1968 republican national convention	C
bonnie newman	C
kansas traditional republican majority	Start
david bowles	Stub
stewart baker	C
conservative talk radio	C
john coghill	C
will kraus	Start
tea party of nevada	Start
jacob miller campbell	Start
thomas gardner ford	Stub
alvin saunders	Start
the flying inn	Stub
alex kozinski	C
richard mack	C
mike ball	Stub
trey gowdy	C
edwin keith thomson	Start
greg hughes	C
anna border	Start
rob kane	Stub
jerry krummel	Start
republican national committee	GA
ed emmett	C
esther hobart morris	B
john milton niles	Start
ron alting	Start
jimmy matlock	Stub
darwin hall	Start
allen quist	C
hazel abel	C
david hogue	Stub
roger allin	Start
triston cole	Stub
john wesley fitzgerald	Stub
randolph townsend	Stub
tina benkiser	Start
david lust	Start
nancy brataas	Stub
isaac colton ash	Start
new york republican primary, 2008	Stub
james traficant	C
monte olsen	Stub
beverly lahaye	Start
harry coates	Start
ebenezer knowlton	Start
ted cruz	GA
norm coleman	C
tom berryhill	Start
lora reinbold	Start
leave us alone coalition	Stub
charles lewis beale	Start
brian darling	C
keith gingery	Start
maggie gallagher	C
kenny hulshof	C
henry billings brown	C
shawn keough	Start
walker blaine	Start
william haile	Start
clay athey	Stub
jonathan everett sargent	Stub
rush limbaugh	GA
dana perino	C
nelson hardwick	Stub
karl denninger	C
wide awakes	B
john forgety	Stub
paul suttell	Start
susa young gates	C
lars larson	C
tom tancredo	B
alice roosevelt longworth	C
republican leadership conference	C
darrell castle	C
ernest istook	GA
libertarian conservatism	C
conservamerica	C
jane bolin	C
george ayittey	Start
idaho republican party	Start
jennifer nassour	Start
stephen fincher	C
dixie carter	C
catharine baker	Stub
manny alvarez	C
case broderick	Start
tommy gollott	Stub
ken knuppe	Start
marlin fitzwater	Start
ronnie dunn	C
marcellus boss	Stub
bret allain	Start
maryland republican party	C
tranquilino luna	Stub
jay ramras	Start
spencer bachus	GA
fay boozman	C
indiana republican primary, 2008	Start
charles crane	Start
daniel gault	C
joanne dru	Start
benjamin ratcliff	GA
david nason	C
jack roeser	C
shannon mcmillan	Start
john mosher bailey	Start
josh heintzeman	Start
eldon rudd	Start
michael cruz	Start
shirley mckague	Start
robert angers	C
walker stapleton	Start
ken hamblin	Start
mike flood	Stub
ray barnhart	GA
ken bennett	C
asher hinds	Stub
john crutcher	Stub
jeffrey amestoy	Start
cleve benedict	Start
diego benavente	Start
mike crapo	C
kenny imes	Stub
bob biggins	Start
midge decter	C
david schizer	Stub
jerry labriola	Stub
joe rogers	Start
chris sununu	C
joel heatwole	Start
preston haskell	C
gerald mcraney	C
hector barreto	Stub
jason brodeur	Start
dan huseman	Start
clarence budington kelland	C
dan clute	Start
charles henry sloan	Start
eddie fields	Start
carl kunasek	Stub
benjamin bridges	Start
ellen roberts	GA
republican party presidential primaries, 1912	C
larry tanimoto	Stub
donald carcieri	C
oley larsen	Start
joni ernst	GA
larry faulk	Stub
robert rice reynolds	GA
william outten	Start
lionel barrymore	B
michael castle	GA
gerald nye	C
carl mcintire	FA
theron akin	Start
lafayette head	C
warner underwood	Start
rogers morton	GA
robert livingston beeckman	C
james damman	Stub
george washington steele	C
dud lastrapes	C
cindy burkett	GA
henry wells tracy	Stub
stephen lindsey	Stub
jim risch	C
barry goldwater	GA
thomas minott peters	Start
john henry kinkead	C
dan kuykendall	C
john cessna	Start
joseph farah	C
the hounds	Start
hiram pitt bennet	Start
william daniel johnson	GA
fred dubois	C
dennis kruse	Start
medford bryan evans	Start
rob astorino	B
david patterson dyer	Start
ray boland	Start
richard ely bird	Start
pat mcdonough	C
philip perry	C
durward gorham hall	Start
william skelly	C
orion clemens	C
alisa kelli wise	Stub
frank harris hitchcock	Start
shantel krebs	Start
justin burr	C
charles diggs	C
bill holtzclaw	Start
samuel johnson pugh	Stub
james bacalles	Stub
edward brooke	C
susan bernecker	Stub
john putnam chapin	Stub
andrew farmer	Stub
william pitt kellogg	C
don gustavson	Stub
steven beckwith ayres	Start
leah cole	Stub
lizbeth benacquisto	C
neal hunt	C
terri bryant	Start
doc hastings	C
john mccain lobbyist controversy	B
1972 republican national convention	C
frank murkowski	C
robert grey bushong	Start
kevin cotter	Start
john lunsford	Stub
maine republican party	C
nancy caffyn	Stub
list of republican national conventions	B
samuel bodman	Start
joseph millard	Start
deskin green	Stub
michelle benson	Start
byron buffington	Stub
richard mellon scaife	B
william sprague iv	C
jake anderegg	C
ray metcalfe	Start
slade gorton	C
tony hwang	C
alan nunnelee	C
frank capra	B
dean alford	Start
peter aduja	C
index of economic freedom	B
ben clayburgh	Stub
eric show	C
tim freeman	Start
thomas aspinwall davis	C
marjorie dannenfelser	Start
bill janklow	C
randy brock	Start
edwin reinecke	Start
michael lamoureux	Start
conrad baker	C
henry chapin	Start
curtis coe bean	C
keith grover	C
al baldasaro	C
marti halverson	Stub
bill markham	Stub
joseph alexander cooper	GA
martin grove brumbaugh	Start
1856 republican national convention	C
bianca garcia	Stub
larry crow	Stub
william woods holden	C
steve munisteri	C
tre hargett	C
philip markoff	C
norine kasperik	Start
steve montenegro	Start
national federation of republican women	C
frank emerson	Stub
ashley todd mugging hoax	Start
barbara bass	Start
donna hutchinson	C
ling ling chang	C
don eldridge	Stub
fred larue	Start
alonzo nute	Stub
jerry behn	Start
william wadsworth evans	Start
jack van mark	Stub
micky hammon	Start
caspar weinberger	GA
seward collins	Start
1880 republican national convention	FA
lee randall	Stub
jewish world review	Start
ragnvald nestos	Start
radical republican	B
stephen balch	C
elliot reid	GA
isabel paterson	C
james frankland briggs	Start
randy mcnally	Start
ben klassen	C
geno martini	Stub
vinton cassidy	Start
bernard shandon rodey	Start
john lement bacon	Start
rebecca paul	Start
it takes a family	Start
margaret hance	Start
asa hutchinson	C
ken blankenbush	Start
stewart iverson	Stub
francine irving neff	Start
david bitner	Stub
elliott broidy	C
frederick cleveland smith	Start
alexander keith marshall	Stub
walter lafferty	GA
jayne meadows	C
christie carpino	Stub
james dennis brady	Start
allen treadaway	Stub
david hartsuch	Start
thomas kuchel	GA
tennessee republican primary, 2008	Start
floyd brown	B
jeffrey chiesa	GA
black conservatism in the united states	B
julie belaga	Start
bill dix	Start
pat nixon	FA
dan branch	C
samuel hill	FA
scott bloch	B
lance pruitt	C
bryan fischer	GA
jack fellure	C
rick santorum presidential campaign, 2016	C
kurt bills	C
center of the american experiment	Start
don goldwater	Start
william pallister hubbard	Start
samuel beach axtell	C
ed kringstad	Stub
ron carver	Start
tim harman	Stub
charles degravelles	C
dennis prager	C
curtis hooks brogden	C
ichabod goodwin	Start
frank iler	Stub
tom bunn	C
justin gonzales	Start
paul dillingham	Start
maxine bell	Stub
justin de witt bowersock	Start
phyllis schlafly	B
john jarman	Start
john francis dodge	C
list of fictional united states republicans	B
lee constantine	Start
theodore mckeldin	C
anne evans estabrook	Start
tim bee	C
tom ervin	Start
brad montell	Start
jacqueline cochran	B
jeannette hamby	C
john schuyler crosby	GA
landon sexton	Stub
mark foley	B
stephen coonts	C
patricia diaz dennis	Start
thomas hedge	Start
vic sprouse	Stub
carter casteel	C
betty brown	Start
william humphreys jackson	Stub
ben boo	Start
cecil dolecheck	Start
dorothy conaghan chiles	Start
clarence thomas	GA
frank eddy	Start
montana republican caucuses, 2008	Start
william gardner hewes	Start
theodore brentano	Start
coors brewing company	GA
marv hagedorn	Start
marilyn giuliano	Stub
hank coe	Stub
charles risk	Start
alphonso barto	Start
edward ackley	Stub
scott boman	GA
philo hall	Start
albert burrows	Stub
solomon comstock	Start
the war room with quinn and rose	B
ronald bacon	Stub
blue dog coalition	C
billy chandler	C
bibliography of the republican party	C
charles frederick joy	Stub
james soloman biery	Stub
don ipson	C
george ambler	Stub
bill beagle	Start
vance dennis	Start
liberty central	C
donald bair	Stub
pat brister	GA
frank aguilar	Stub
william langer	C
iron sky	C
red state	Stub
jon bruning	C
bill chumley	Stub
louise gore	Stub
ralph alvarado	Start
mary jane bowes	Start
arizona republican party	C
green adams	Start
mike cheokas	Stub
carleton perry	Stub
granville hinton	Start
george corbin washington	Start
john culberson	C
strom thurmond	B
robert bondi	Start
james henry dickey henderson	Start
randy asbury	Start
republican party of virginia	B
karen fann	Stub
juliana geran pilon	Start
spencer hawes	C
mike holm	Start
frederick miles	Start
marion butler	C
republican party vice presidential candidate selection, 2008	C
frank luntz	B
tom azinger	Start
joseph gimse	Start
william claflin	GA
henry alden clark	Start
rob bradley	Start
steve bartlett	C
federalist party	B
merrill nelson	Start
maurice carey blake	Stub
dick devos	B
randy scheunemann	C
unfit for command	C
patrick connick	Start
constitution party of oregon	C
marcus richmond	Start
al dekruif	Start
francis lewis cardozo	C
karen boback	Start
carter glass	C
constitution party national convention	C
peter bragdon	Stub
arthur hornbui bell	C
governorship of sarah palin	B
james cagney	FA
leonore annenberg	GA
bobby carter	Start
joni craighead	B
southern strategy	B
rick brattin	Start
paul bannai	Start
national republican senatorial committee	Start
david caton	C
andrew jackson kirk	Stub
bob lynn	Start
lawrence murphy	Start
sam slom	C
levi ankeny	Start
thomas ray hamer	Start
scott craig	Stub
alvan flanders	Start
rex rammell	C
steven dickerson	Start
mitch daniels	GA
trent lott	GA
jimmy field	Start
goldwater institute	C
ryland fletcher	C
matthew shepherd	Start
josiah bushnell grinnell	Start
hunter greene	C
ernesto lopez	Start
carol schwartz	GA
eddie tallon	Stub
addison james	Stub
justin olson	Start
clarence norman brunsdale	Start
hugh douglas barclay	Start
better this world	Start
moral majority	GA
john schiffer	C
mike leavitt	C
walter dwight bradley	Stub
nathaniel greene foster	Start
les adams	Stub
paul mcdonald calvo	Start
the heartland institute	C
paleoconservatism	GA
imprimis	C
anthony sykes	Start
donald difrancesco	C
katrina shealy	Start
nebraska republican primary, 2008	Start
travis holdman	Stub
paul whalen	Stub
aaron russo	C
wesley duncan	Start
vern larson	Stub
steve drazkowski	Start
william henry vanderbilt iii	C
public image of sarah palin	B
black belt patriotism	Start
corinne freeman	Stub
george william curtis	C
nathan deal	GA
dixon pitcher	C
tim griffin	C
robert schliske	C
deb peters	Start
plug uglies	Start
grailey berryhill	Start
what would reagan do?	Start
jeremiah haralson	C
albert cobo	Start
ethel baker	Stub
raymond bunt	Stub
monica goodling	C
meghan mccain	GA
melissa magstadt	Start
frank artiles	Start
charles ready	Start
goproud	C
john jacob astor iv	C
jonathan bowman	Stub
johnnie byrd	Start
scott bundgaard	C
winthrop paul rockefeller	C
adolph olson eberhart	Start
wayne dumont	Start
henry cullen adams	Start
charles billinghurst	Start
suzanne deuchler	Start
mark brnovich	Start
richard devos	C
richard mourdock	GA
adelbert bleekman	Start
james heller	C
william sharon	Start
puerto rico republican primary, 2012	C
operation payback	FA
government bullies	Stub
george washington logan	Start
ted nugent	B
benjamin travis laney	Start
jerry dempsey	Stub
scott gessler	C
tom reeder	Stub
robin lundstrum	C
brooke astor	C
henry aldous dixon	Start
josiah spaulding	Start
rufus mallory	GA
sherry huber	Stub
ralph hise	Start
bill cassidy	C
catholic digest	Stub
william fralin	Start
mary ann carson	Stub
maureen tucker	C
priscilla owen	C
paul craig roberts	GA
wade kach	C
list of united states republican party presidential tickets	C
kermit brown	Start
mason sears	Start
dick wallis	Stub
center for security policy	GA
prissy hickerson	Start
joe pyne	C
dan moody	Start
jon lynn christensen	Stub
ivy baker priest	Start
asa fowler	Start
dwight cook	Stub
rudy giuliani presidential campaign, 2008	B
robert helm	Stub
trey grayson	C
john hagee	B
mary pat angelini	Start
benjamin warren couch	Stub
jillian balow	Start
stephen meeks	Start
randy altschuler	C
george van peursem	Stub
nadine conner	C
rodney alexander	C
ben bubar	Start
1992 republican national convention	C
john marshall harlan	C
earl butz	C
john hicklin hall	C
vaneta becker	Start
walt bachrach	Stub
sonny bono	C
diane allen	C
john grenier	B
jane amero	Start
fred dryer	C
eva bowring	Stub
bud wilkinson	C
amy kremer	GA
mark levin	GA
connie doepke	Start
electoral history of barry goldwater	Start
robert erbele	Stub
eric hoplin	Start
henry kissinger	FA
robert worth bingham	C
the conservative caucus	Start
california republican primary, 2004	Stub
stuart bishop	Start
william henry purnell	Start
tom osborne	C
pat george	Start
donald bratton	Start
new jersey conservative party	Start
barry doss	Stub
steve westfall	Start
lewis mcallister	Start
dub williams	Stub
ed burr	Start
gary richardson	Start
asma gull hasan	C
tony feather	Stub
john green brady	Start
selim noujaim	Start
tim stubson	Start
albert sommers	Stub
isaac bacharach	Start
eric householder	Start
james wickstrom	C
bert stedman	Stub
don batchelor	Stub
glen kolkmeyer	Start
edward dickinson baker	C
jonah goldberg	C
craig estes	Start
mabel king	Start
don draper	C
ralph homan	Stub
james allen main	Start
charles koch	GA
mary fallin	GA
john engler	C
stephen silberkraus	Stub
harris coleman	Stub
david omdahl	Stub
val peterson	Start
michael hahn	GA
jack fields	Start
ric killian	C
mark dosch	Stub
henry gardner	GA
gust kundert	Stub
rick hill	C
wyoming republican caucuses, 2008	C
beverly masek	Start
elisha dyer	C
bill flores	C
william hugh smith	Start
richie robb	Start
onslow stearns	Start
ebenezer dumont	Start
eugene jerome hainer	Stub
wells goodykoontz	Start
bradley last	C
ronald edward meredith	Start
sonny perdue	C
cathie adams	GA
northern mariana islands republican caucuses, 2008	Stub
scott crichton	Stub
doug eckerty	Stub
timothy villagomez	Start
alvin bush	Start
jon mcbride	C
1964 republican national convention	C
1920 republican national convention	GA
john mathis	C
the republican brain	Start
sam coon	Start
demonic: how the liberal mob is endangering america	Start
african american engagement office	Stub
don blankenship	B
frederick augustus tritle	GA
tito the builder	C
irv greengo	Stub
larry haler	Stub
henry washington hilliard	C
home school legal defense association	C
patti komline	Stub
bette grande	Start
american samoa republican caucuses, 2008	Stub
ralph hudgens	Start
john albion andrew	FA
tea party protests	FA
louisiana republican caucuses and primary, 2008	GA
bill desteph	Start
rita campbell	Start
scott cadle	Stub
stephen speed	Start
john shadegg	GA
terry rice	C
charles wilson pierce	Start
the mark levin show	C
heritage action	GA
winthrop rockefeller	C
dan smoot	C
carolyn crawford	Stub
harold hughes	C
republican party presidential primaries, 2012	GA
electoral history of the conservative party of new york state	B
nilda pedrosa	Start
james kasper	Stub
horace elgin dodge	C
bob dole	GA
ross tolleson	Stub
hawaii republican party	C
robert badham	Stub
richard brookhiser	C
sonny borrelli	Start
lance cargill	Start
dan greenberg	C
kay christofferson	Start
monica crowley	Start
william raggio	Start
maurice washington	Stub
thomas lockhart	Start
samuel maxwell	Start
frank hanly	GA
diemer true	Stub
guy benson	C
alferd packer	C
richard alloway	Stub
jim marriott	Start
ryan keyser	Stub
emil baensch	Stub
ken andrus	Start
william heiskell	B
georgia teen republicans	Start
stephen smyk	Stub
republican party presidential primaries, 1984	Start
harvard salient	Stub
rex van de kamp	C
edwin godwin reade	Start
william french smith	C
henry bowen	Start
ben stevens	C
levi coffin	GA
bob gable	Stub
marvin burt	Stub
mark buesgens	Start
bina deneen	GA
allan levene	C
eugene delgaudio	C
christopher demuth	C
daniel schaefer	Start
thad hutcheson	Start
randy burckhard	Stub
order of the star spangled banner	Start
keith kempenich	Stub
terry considine	Start
north carolina republican primary, 2008	Stub
jon grunseth	C
patrick hatlestad	Stub
roy acuff	GA
bob giuda	C
south carolina republican party	C
ken fanning	Start
george burnham	Start
cliff stearns	B
richard glorioso	Start
manuel ayau	Start
karl boyes	Stub
william peters hepburn	C
steve gottwalt	C
bunky loucks	Start
pete abele	Start
william tecumseh vernon	C
henry aldridge	Start
margaret carpenter	Stub
eugene talmadge	GA
brian gosch	Start
bill mcinturff	Stub
samuel blatchford	C
bob riley	C
greg ganske	Start
john hays hammond	C
jim carns	Start
rick goddard	Start
zenas ferry moody	Start
robert william davis	Start
frank riggs	Start
jessica upshaw	Stub
eric motley	Start
elfego baca	C
james speed	C
henry taylor blow	C
james carafano	C
janet barresi	Stub
bob bastian	Stub
rusty humphries	C
anthony ellmaker roberts	B
jeff colyer	C
todd wade	C
bernard akana	Start
kitty walker	C
cable communications policy act of 1984	C
michael scanlon	Start
sam krone	C
laura ingraham	C
foreign policy research institute	C
howard lloyd kennedy	Stub
phil valentine	C
stanford darger	Stub
george washington julian	C
doug carlson	Stub
social conservatism in the united states	C
betty andujar	GA
arthur laban bates	Stub
adam kokesh	GA
ann bedsole	C
martin causer	Stub
jason crowell	C
carey baker	Start
harold gray	C
allen loughry	C
tilman goins	Start
fred emerich	Start
ed foreman	C
regina egea	C
gray tollison	Start
thomas greason	Start
kate campanale	Stub
constitution party of wisconsin	Start
john quincy adams ii	C
gunder olson	Stub
seth bullock	GA
icon comics	Start
cora brown	Start
hiram fong	C
allen farley	Stub
john james ingalls	Start
ed gillespie	C
rob bishop	C
theblaze	C
william flinn	C
alfred buntin	Stub
james shepherd pike	C
victor emanuel anderson	Start
henry augustus buchtel	Start
freedomworks	GA
john pool	Start
john mclane	Start
mitch toryanski	Start
alexander caldwell	Start
florence king	C
carol springer	Stub
kermit brashear	Start
mark amodei	C
joe chasteen	Stub
sandpoint, idaho	C
rousas rushdoony	GA
mark biviano	Start
denton darrington	C
eric hutchings	C
alvin peterson hovey	C
pam bondi	GA
edward degener	Start
bill cowsert	Stub
harvey feldman	C
mel richardson	Stub
charles coburn	C
mike bost	C
mittromney	Stub
pat freeman	Stub
charles russell davis	Start
political positions of pat buchanan	C
tom bolack	Start
mark bircher	Start
dean sanpei	C
eric voegelin	C
william cannon	C
pat boone	B
joseph franklin ada	C
i hope like heck	Start
jim wheeler	Stub
tom griscom	C
ronald machtley	Start
richard hewes	Start
ann coulter	GA
isaac ambrose barber	Stub
milton kraus	Stub
paul bettencourt	C
vito barbieri	Start
bill ballenger	Start
joe acinapura	Start
donald flores	Stub
willard preble hall	Start
marjorie holt	Start
jeff groscost	Start
craig benson	C
glenn murdock	Stub
ron mendive	Stub
wanda cornelius	Stub
hawaii tea party	Stub
alaska public safety commissioner dismissal	B
alvah crocker	Start
terry crapo	Start
paul schumacher	Stub
david durenberger	C
john milton thayer	C
skip brion	Stub
lynn lowe	GA
steven ford	C
james devereux	C
eagle forum	GA
elford albin cederberg	Start
richard shelby	GA
john hamilton morgan	Start
bernard marcus	C
ben carson presidential campaign, 2016	FA
ripon society	GA
sidney edgerton	GA
neil combee	Start
robert cluck	Start
richard cunningham mccormick	C
saturday night live parodies of sarah palin	GA
jacob hart ela	Start
henry justin allen	Start
news world communications	Start
kirk adams	C
tony guglielmo	Stub
erick erickson	C
iron sky: the coming race	C
don armes	Start
steven burd	Start
brian langley	Start
stephen goldsmith	C
mike hager	Stub
adelina domingues	Start
becky duncan massey	Start
bruce castor	C
porter goss	C
aaron jack	Start
benjamin manglona	C
george dewey clyde	Start
jim keet	C
francis william billado	C
carl harstrom	C
wallace rider farrington	Start
jack draxler	Start
john eisenhower	C
kansas republican caucuses, 2008	Stub
1944 republican national convention	Start
sanford bates	C
ron marlenee	Start
kristin conzet	Start
marianne lamont horinko	C
sandy adams	C
robert jay mathews	C
jim denning	Stub
james francis thomson	Stub
pat fallon	GA
jeannie haddaway	C
kevin elsenheimer	Start
lynn frazier	Start
steve fitzgerald	Stub
carolyn pollan	C
wendell cox	C
dana loesch	C
anna chennault	C
william penn patrick	C
charles debrille poston	GA
hank brown	Start
peter angelo cavicchia	Start
samuel mayes arnell	Start
john oxendine	C
henry clausen	C
thomas massie	GA
robert cutler	Start
william mckee dunn	Start
timothy goeglein	C
osro cobb	B
james dixon	Start
tom feeney	C
mike montandon	Start
jim sheets	B
new jersey republican state committee	Start
william cook hanson	Start
edwin bideau	Start
randy forbes	C
bud day	GA
michele fiore	GA
jonathan jordan	Stub
robert depugh	Start
bring us together	FA
murray chotiner	FA
connecticut republican party	Start
brian hoven	Stub
wayne newton	GA
victor christgau	Start
phyllis heineman	C
washington duke	C
jane du pont lunger	Start
lance harris	C
charles case	Start
tim rave	Stub
district of columbia republican committee	Start
sondra erickson	Start
ralph carey geer	C
jay webber	C
emilio cantu	Stub
peter micciche	Stub
jerry bonnet	C
kelley packer	Stub
ried holien	Start
mike kehoe	Stub
chester byerly	Stub
corey stapleton	C
page cortez	C
victoria clarke	Start
john knotwell	Start
lewis barker	Stub
joseph john martin	Start
charlton lyons	FA
ted haley	Stub
suzette raines	Stub
gus fleischli	Stub
insight on the news	GA
edmund william mcgregor mackey	Start
wendell bailey	Start
faisal gill	Start
ryan aument	Start
john brenden	Stub
chris meek	C
nancy adams collins	Start
richard barrett lowe	C
lisa johnson billy	Start
john edward bouligny	Stub
trip pittman	Stub
john william finn	GA
kenneth fredette	C
frank brogan	C
tom cole	C
carroll chaplin	Stub
emmet byrne	Stub
al novstrup	C
hannibal hamlin	C
herbert stephenson boreman	Start
mitch mcconnell	GA
joel broyhill	C
shelby cullom davis	Start
ralph townsend	FA
todd kincannon	C
george maney	C
click bishop	Stub
paul deparrie	Stub
albert levitt	C
george jefferson	C
ken bragg	Start
mike enzi	C
1892 republican national convention	C
campaign for liberty	C
paul bremer	B
luke malek	Stub
franklin center for government and public integrity	C
gerardo del tufo	Stub
carl crane	Start
mike curb	GA
josh duggar	GA
jack ladyman	Start
joseph coors	C
california republican assembly	Start
don kopp	Start
samuel cony	Start
leadership institute	Start
tony tinderholt	Start
john mccain	FA
samuel alito	GA
john broujos	Stub
james cabanis	Start
ada mills	C
youth for western civilization	C
john roberts	B
william ball gilbert	C
orator henry lacraft	Stub
jeff foxworthy	C
karen arvon	Start
dan benishek	C
jack abramoff	GA
solidarity electoral action	Start
lisa murkowski	C
steve hurst	Stub
andrew leo bettwy	C
the betrayal of the american right	Stub
joel funk asper	Start
eric barlow	Stub
kinky friedman	GA
common nonsense	C
william hopkinson cox	C
ben cline	C
henry bethard	GA
william robert moore	Start
kristi noem	GA
eric tanenblatt	C
peter jansen	Stub
floyd spence	C
james strickler	Start
mark dudenhefer	Start
political positions of sarah palin	B
pete hoekstra	GA
help! mom! there are liberals under my bed	Start
william hebard	Start
jim battin	Start
mark hargrove	Stub
dean burch	Start
steve beren	C
conservative manifesto	Start
john newbold camp	Start
joe foss	B
geoff connor	GA
ellen bork	Start
ralph pomeroy buckland	Start
buckner stith morris	Start
bruce cozart	Start
samuel steel blair	Stub
maynard clemons	Stub
saint paul, minnesota	FA
sidney curtiss	Stub
clint day	Stub
paula benoit	Start
josh barro	C
stanford morse	GA
christopher chandler	Start
william gannaway brownlow	FA
christopher payne	C
scott desjarlais	GA
harold haering	Stub
rollye james	C
margaret conditt	Stub
bryce harlow	C
hugh scott	C
ben bernanke	GA
william waldorf astor, 1st viscount astor	C
henry smith lane	C
nancy schaefer	Start
john barrasso	C
sterling small	Stub
donna finley	Stub
john bingham	C
beau boulter	Start
bill kauffman	B
kendel ehrlich	Start
toby herald	Stub
harry lynde bradley	Stub
orestes brownson	C
william bennett	C
edwin peacock iii	Start
national taxpayers union	C
denny rehberg	C
janette hales beckham	Start
warren atherton	C
mississippi republican party	C
asa hodges	Start
robert crozier	Start
oklahoma republican primary, 2008	GA
jim rappaport	Start
arthur cory	Stub
heather fitzenhagen	Start
pete domenici	C
stephen broden	C
willie person mangum	Start
elaine bowers	Start
mitt romney	FA
george cabanis	Start
northern mariana islands republican caucuses, 2012	C
homer bone	Start
gravina island bridge	GA
dave argall	Start
clifford hansen	GA
shirley marsh	Stub
tom capella	C
gay kernan	Start
selucius garfielde	GA
bibliography of conservatism in the united states	B
michele bachmann presidential campaign, 2012	GA
jim bunn	Start
hugh hallman	C
edward leo delaney	Start
lee hein	Stub
weekly republican address	B
real news	Start
gail griffin	Start
james noble tyner	GA
1960 republican national convention	Start
pat colloton	Stub
the tea party goes to washington	Start
dave farnsworth	Start
mark brody	Stub
david ralston	Start
john motley morehead ii	Stub
ted cruz presidential campaign, 2016	FA
james jefferson britt	Start
john burton thompson	Start
robert adelmann	Start
robert brawley	Start
david mckinley	C
ray garofalo	Start
rudolf doehn	Start
ozias bowen	Start
jason chaffetz	GA
stephen colbert	GA
barbara bailey	Start
john allen campbell	Start
daniel polsley	Start
cincinnati riots of 1855	Start
clare boothe luce award	Start
john bechtold	Stub
frank dunklee currier	Start
kurt olson	Stub
mike mcginness	Stub
jack swigert	C
fat tony	Stub
thomas jefferson halsey	Start
henry baldwin harrison	Start
randy owen	C
stephen bainbridge	Start
florence fifer bohrer	C
the american spectator	C
thompson campbell	Start
chip limehouse	Start
negro republican party	Start
doug funderburk	Start
daryl cowles	Start
carl karcher	C
dan forest	C
lynne cheney	C
jedediah bila	Start
paul weyrich	B
tea party express	GA
william henry chamberlin	Start
stacey guerin	Stub
kirk dillard	C
oliver hall	Stub
louis wade sullivan	C
william benjamin baker	Start
ross barnett	GA
nathaniel green taylor	C
markwayne mullin	C
mack cleveland	Start
harold hagen	Start
bill frenzel	C
morton blackwell	Start
colin bonini	Start
gang of seven	Start
brett buerck	Stub
ginny coppola	Stub
rand paul presidential campaign, 2016	B
john hammill	Start
john bohlinger	Start
dale thompson	C
marti coley	Start
chip pickering	C
david schnoor	C
american majority	C
mason brayman	C
john hostettler	B
frank farkas	Stub
marc zell	Start
rob couhig	C
richie farmer	FA
bob cashell	Start
matt kibbe	C
bill brock	C
george whaley	Stub
francis clyde duffy	Stub
lionel allen sheldon	Start
jesse helms	B
tom horne	B
james hepburn campbell	Start
adam laxalt	Start
hazel beard	C
barbara bollier	Stub
seminar caller	Stub
francis grevemberg	B
brian and the judge	Stub
troy eid	B
bob jones iii	C
gerald ford	GA
harlan hobart grooms	Start
joanne benson	Start
james lankford	C
christian mcdaniel	Start
princella smith	Start
andrea lea	C
nathan bech	Start
sebastian streeter marble	Start
duane ankney	Stub
sue lowden	GA
national black republican association	Stub
calathumpian	Start
roger katz	Start
simon guggenheim	Start
emerson etheridge	GA
jim herring	Start
augustus herman pettibone	Start
brian babin	GA
glenn mccullough	Start
andrew jackson barchfeld	Stub
kevin grantham	C
robin hayes	C
betty heitman	C
mack mattingly	Start
henry clay payne	Start
roger ailes	B
tammie wilson	Start
william clay cole	Start
dale devon	Stub
jane hadley barkley	Start
goldwater rule	Start
dimitri polizos	Stub
jim halligan	Start
steve forbes	C
leslie osborn	Start
morgan bates	Start
doug overbey	Start
mary duvall	Stub
fred astaire	B
list of allegations of misuse of the internal revenue service	C
north carolina republican party	C
pete nielsen	Start
carl gatto	Start
gaston cantens	Stub
america by heart	C
brad mayo	Stub
david meeks	C
john brabender	Start
john cornyn	C
dewitt hyde	Start
garry cobb	C
vincent illuzzi	C
kit spires	Stub
herbert hoover	B
anne thayer	Stub
gary allen	C
william henry coleman	Stub
rusty paul	Stub
reagan day	Start
bruce caswell	Start
william henry hunt gleason	Stub
bryan clay	C
elliott anthony	Start
nicholas murray butler	C
harry hinde	Start
chris dudley	GA
republican party presidential primaries, 1948	C
garey forster	GA
isaac goodnow	Start
voter vault	Stub
john henry kirby	C
merlin bartz	Start
mary beth buchanan	B
randy brogdon	C
henry winter davis	C
les eaves	Start
benjamin pierce cheney	C
gale norton	C
larry chatzidakis	Start
kathy crawford	C
bradley byrne	C
leslie jensen	Start
robert bloxom	Stub
colette nelson	C
jim gilmore presidential campaign, 2008	GA
mike huckabee presidential campaign, 2016	C
thomas swann	C
brian krolicki	C
john mccuskey	Start
frank llewellyn bowman	Start
arkansas republican primary, 2008	Stub
marco rubio	FA
raymond cox	Start
rex barnett	Start
to save america	C
alvin jaeger	Start
andrew jackson faulk	Start
lee fletcher	GA
tom fetzer	C
cory fong	Start
richard duhaime	Stub
darrell crate	Start
rockford institute	C
alan keyes	GA
richard bartholdt	Start
lindsey tippins	Stub
eli bebout	C
linda menard	Start
republican party presidential candidates, 2008	GA
ryan frazier	C
ben bagert	C
joe ellington	Start
ted washburn	Stub
jim kolbe	C
mike chaney	Start
charles herbert allen	C
david funderburk	Start
michael dell	C
perle mesta	Start
pat ingraham	Stub
in defense of internment	C
homer hoch	Start
henry dworshak	C
guy hovis	Start
julius caesar chappelle	FA
sherlock james andrews	Start
republican party presidential primaries, 1956	Start
wisconsin republican primary, 2008	Start
gerald geis	Start
jeff frederick	C
john alario	C
owen brewster	C
joanne blyton	Stub
buddy fowler	Stub
david grant colson	Start
ken paxton	GA
spencer abraham	C
paul helmke	C
republican party presidential primaries, 1944	Start
bob dettmer	Start
jeb bush	GA
thad viers	Start
hugh ike shott	Start
silas adams	Start
john boozman	GA
mike church	Start
wilbur foss	Start
sheldon adelson	B
thomas amos rogers nelson	B
romulus zachariah linney	Start
steve huebert	Stub
burleigh martin	Stub
william daniel brayton	Start
william sharer	Start
drudge report	GA
dave cowens	C
odell mcbrayer	Start
elizabeth halseth	Start
john peavey	Start
rip raps	Start
kent glasscock	Start
terrie huntington	Start
shawn bradley	C
cliff bentz	Start
lucien baker	Stub
george jonathan danforth	Stub
robin ficker	GA
edwin hanson webster	Start
joan ballweg	Start
val bjornson	Start
susan fagan	Stub
william randolph hearst	B
roger fairchild	Stub
roger wicker	C
keith babb	C
bruce weyhrauch	Start
nicholas quinn rosenkranz	C
connecticut republican primary, 2008	C
randy brodehl	Stub
travis tritt	GA
ken blackwell	B
jeff cragg	C
harry nice	Start
lew wallace	FA
eldridge cleaver	C
1952 republican national convention	Start
jim carmichael	Stub
dan griffey	Stub
john derbyshire	C
person colby cheney	Start
prentiss walker	C
james mitchell chase	Stub
todd thomsen	C
ralph flanders	FA
jeannette rankin	GA
george alexander parks	GA
william thomas clark	Start
curtis frazier	Stub
bill sali	C
russ weeks	Start
john amari	Start
ellen craswell	C
jack buechner	C
the politically incorrect guide	C
lee baca	C
elijah easton	Start
bob stenehjem	Start
mick staton	Start
mimi miyagi	C
alaska republican party	C
puerto rico republican party	C
chauncey fitch cleveland	Start
known and unknown: a memoir	GA
bob nonini	Start
robert dinsmore harrison	Start
rnc 8	Start
mac toole	Stub
mike moyle	Start
dana layton	Start
fred dyson	Start
jon barela	C
not afraid of life	Stub
dwight griswold	Start
hubert houser	Start
romanzo bunn	Stub
james antonio	Stub
lou blessing	C
alan bluechel	Stub
clinton harden	Stub
james holtzclaw	Stub
perry buck	Stub
sandy crawford	C
tom delay	B
dell raybould	Start
cyd charisse	GA
cliff clevenger	Stub
list of john mccain presidential campaign endorsements, 2008	GA
kenny bowen	B
jeannemarie devolites davis	C
thomas kearns	C
benjamin butterworth	Start
finlay rothhaus	Start
randall luthi	Start
james harbord	C
republicans abroad	Start
jay fant	Start
terry branstad	GA
bubber epps	Stub
1928 republican national convention	GA
ross doyen	Stub
hal suit	Start
harrison loesch	Start
greg anthony	C
gary banz	Start
lorenzo brentano	Start
john hull campbell	Stub
jerome blatz	Stub
paul gourley	Start
south dakota republican party	Start
kansas republican party	FA
generation opportunity	C
steven thayn	Start
tom graves	C
conservative political action conference	GA
bob mcdonnell gubernatorial campaign, 2009	B
bill haslam	GA
harvey marion lafollette	C
edward redd	Start
lee greenwood	C
john ehrlichman	C
charles anderson dana	C
solomon foot	C
john adams	FA
dave brat	GA
dennis bonnen	GA
marian heiss price	Start
amy tuck	Start
james gillett	GA
grace raymond hebard	FA
edgar cason	C
jennifer stefano	Stub
roy ashburn	GA
alfred alexander freeman	B
terry boose	Start
henry converse atwill	Stub
shawn jasper	Start
rex bell	C
cushman kellogg davis	C
mary littleton	Stub
jeffrey welborn	Stub
chip cravaack	GA
international republican institute	C
thomas carney	Start
dan crane	Start
lynn finnegan	Start
cathy cochran	C
hiram price	Start
gene ward	Start
kevin garn	C
dwight loomis	Start
ossian ray	Start
blair thoreson	Start
william daniel mayer	Start
hal rogers	C
marshall christmann	Stub
jamie kelso	Start
willis glassgow	GA
mike delph	C
andrew napolitano	C
steve harshman	Start
vicki berger	C
jason gant	Start
james mcduffie	Stub
phil hamilton	C
cecile bledsoe	Start
stephen benton elkins	C
victor gaston	Start
susan weddington	C
walter folger brown	Stub
gale thomson	GA
sal santoro	Start
kathleen chase	Start
john bassett moore	Start
bill garrard	Stub
lynn jenkins	C
2004 republican national convention	B
paul gazelka	Start
william valk	Stub
levi cook	Start
john bahnsen	GA
koch family foundations	C
erastus brooks	Start
pete higgins	Start
henry waldo coe	C
judy martz	C
ann bartlett	C
hugh hewitt	GA
robert genuario	C
charlene fite	Start
rnc welcoming committee	Start
kenneth goff	Start
christy perry	Start
david kranich	Start
kent calfee	Stub
anthony bucco	C
craig berkman	C
drew wrigley	Start
robert hahn	Start
roger ishee	Stub
mike nearman	Stub
isaac murphy	C
bob krist	C
herbert james hagerman	C
robert bork	GA
dana bumgardner	Stub
ben glardon	Stub
debra moody	Stub
james william good	Start
jule berndt	Stub
georgia republican primary, 2008	Stub
republican party presidential primaries, 1952	C
orville bullington	GA
1980 republican national convention	C
aaron goodrich	C
ray rawson	Stub
ron highland	Stub
joe balyeat	Stub
matt teeters	Start
larry mccarthy	Start
joseph carter abbott	C
paul crespo	B
conservapedia	FA
daniel henry chamberlain	C
brett hildabrand	Stub
john paul hammerschmidt	C
thaddeus mccotter presidential campaign, 2012	FA
henry linde	Stub
jean ginn marvin	Stub
california patriot	Start
jimmy mathis	Start
harry klock	Stub
anson allen	Stub
american thinker	Start
randy graf	Start
joe arpaio	FA
chuck connors	C
carl bearden	Start
ken lackey	Start
craig brandt	Stub
larry hibbard	Stub
bruce rampelberg	Start
stanley barnes	Start
alaska mental health enabling act	FA
bobby schilling	GA
washington state republican party	GA
terry lathan	Start
chris christie	GA
tim dore	Stub
michael don brandenburg	Stub
ken starr	GA
harris ellsworth	Start
john boehner	B
colorado republican caucuses, 2008	Stub
david daniel marriott	Start
walter eli clark	C
dennis moss	Stub
ray holmberg	Stub
ken coon	B
bernard ayotte	Stub
mark blasdel	Stub
wendy lee gramm	Start
hiram bond	B
feminazi	C
arthur fletcher	Start
debra medina	C
walter mcnutt	Stub
leslie bradley cutler	Start
george washington anderson	Stub
schuyler colfax	GA
adam carolla	GA
newt gingrich	GA
seldon connor	Start
rebecca petty	C
woody freeman	GA
harry shiver	Stub
odell pollard	C
richard lucero	Stub
lia roberts	Stub
nils boe	C
medorem crawford	C
walter russell stiness	Start
william berndt	Stub
david dank	Start
linda chavez	GA
margaret hoover	C
phyllis katsakiores	Start
john hubert hall	Start
joe driver	Start
ted gatsas	Start
jeff angelo	Start
grover norquist	B
sean connaughton	C
william alfred buckingham	C
hoover institution	C
bloomington convention	B
randy davis	Stub
dwight chapin	Start
robert smalls	GA
sharon cooper	Stub
amy ridenour	B
johnny berthelot	Start
kendell kroeker	Stub
gustavo barreiro	Stub
gordon helsel	Stub
lafayette holbrook	Start
donald roe ross	Start
tammy bruce	C
law and order party of rhode island	Start
erastus benson	Start
julia hurley	Start
texans for a republican majority	Start
rick santorum	GA
larry parman	Start
jim betts	Stub
republican party of american samoa	Stub
robert waring stoddard	C
1908 republican national convention	C
marsha barbour	Stub
morrie ryskind	B
eugene hale	Start
dave cogdill	C
karen minnis	Start
todd caliguire	Start
katherine harris	B
stephen allison	Start
james comey	GA
lance eads	Start
oscar bartlett	Start
donors trust	GA
elizabeth dole	B
richard darman	Start
david condon	C
derham cole	Stub
ward connerly	C
alveda king	C
janice bowling	Start
albert hobbs	Stub
nancy dahlstrom	Start
peter cownie	C
ann womer benjamin	Start
susan combs	Start
douglas kary	Stub
pete brungardt	Start
jacob thorkelson	Start
life at the bottom	GA
bird segle mcguire	Start
sarah minear	Stub
william hanes ayres	Start
william woodburn	Stub
edward buchanan	Start
tony meeker	Start
nic lott	Start
derrick kitts	GA
plain talk	Stub
algernon sidney badger	C
creighton lovelace	Start
rockefeller republican	C
tim lemons	Stub
ann mclaughlin korologos	Start
francis gillette	Start
independent american party of hawaii	Stub
jim fulghum	Stub
rush bullis	Stub
columba bush	GA
peter degraaf	Start
illinois republican party	C
steve merrill	Start
fred costello	Start
nancy jacobs	C
raymond bateman	Start
roeliff brinkerhoff	C
leslie heinemann	Stub
yvette herrell	Stub
spiro agnew	B
council of conservative citizens	C
wyatt earp	FA
james paul johnson	Start
jeff monroe	C
roger clemens	GA
carole hillard	Start
jeremiah davis	Start
george meade bowers	Start
henry salvatori	Start
eric brakey	C
hawaii republican caucuses, 2008	C
james hirni	Start
lora hubbel	Start
john kuehn	C
mugged: racial demagoguery from the seventies to obama	B
charles boustany	C
curt levine	Start
ron bean	C
william marion jardine	C
fran amos	Start
david hann	C
fred burrall	Stub
charles inman	C
dallas heard	Stub
denison kitchel	GA
len fasano	Start
john henry baker	C
jenean hampton	C
jim brulte	Start
kevin hornberger	Stub
cynthia cloud	Start
roger halvorson	Stub
bernard fontaine	C
george israel	C
mark quandahl	Start
rich golick	Stub
joy corning	Start
ruben barrales	C
peter beter	C
jacob collamer	C
roy clippinger	Stub
theodore abrahamson	Start
paul digaetano	Start
bill adolph	Start
denny jones	C
going rouge	C
manuel herrick	Start
draft goldwater committee	B
rhonda keenum	Start
michael retzer	C
bob bethell	Stub
alan paul anderson	Stub
cheryl avioli	Stub
brian wilshire	Start
restoring honor rally	FA
dead rabbits riot	B
bill sandifer, iii	Stub
mitt romney presidential campaign, 2012	GA
jay emler	Start
liberal fascism	C
tim kapucian	Stub
carolyn whitney branagan	Stub
young americans for liberty	C
ted poe	GA
dennis kriegshauser	Stub
leon lombardi	Stub
albert jennings fountain	C
michael frey	Stub
is the school house the proper place to teach raw sex?	Start
rick romley	Start
kevin cramer	B
kim koppelman	Start
frank kell cahoon	GA
jesse smith henley	Start
nile gardiner	C
john insley blair	C
nora espinoza	Start
tea party patriots	C
mike stepovich	GA
erastus newton bates	Start
sandra townsend	Stub
leander cox	Stub
the rise and fall of the christian coalition	Start
william koepsel	Stub
william cogswell	C
daniel phillips upham	Start
brian linder	Stub
warren chisum	C
steve bair	Start
don thorson	Stub
quentin dastugue	C
john quincy adams	FA
republican national lawyers association	Stub
becky currie	Stub
martha roby	C
laura ebke	C
pat saiki	Start
benigno fitial	GA
vernon wallace thomson	Start
louis bacon	C
phil english	C
movement conservatism	GA
texas patriots pac	Start
brandt smith	Start
happy chandler	FA
sherman bardwell	Stub
dean cray	Stub
julio brady	C
hollis downs	C
joe kyrillos	C
larry luick	Stub
otto kundert	Stub
kathy cox	Start
bill gibbons	Start
detective chimp	C
alvin morell bentley	C
steve largent	C
juan chastang	Start
warren giese	C
james tufts	Start
david catania	C
pat browne	Start
robert maginn	Start
jesus sablan	Stub
larry pratt	C
tim huelskamp	C
arthur capper	C
don haggar	Start
henry kirke porter	Start
foster friess	C
richard joseph hopkins	Stub
joseph howell	Start
pat brown	B
franklin william fort	Start
lynn westmoreland	C
charles stimson	C
james carson gardner	C
lamar baker	Start
william herod	Start
mickey cafagna	Start
lincoln almond	C
jason harper	Start
john david merwin	Start
thaddeus stevens	FA
louise shadduck	C
lionel rivera	Start
mark alton barwise	Start
paul curtman	Start
james morrison harris	Stub
ed charbonneau	Stub
alex mooney	C
lila walter evans	Stub
pardee butler	C
anne gorsuch burford	C
pat grassley	C
mick mulvaney	C
randy kirner	Start
death panel	FA
clifford may	C
milton balkany	C
emmett forrest branch	C
foster waterman stearns	Start
binger hermann	GA
nichi farnham	Start
mark pody	Start
james fergus	Start
nathan cole	Stub
ernie otten	Start
family research council	B
jim bird	Start
greg brophy	C
fin tutuola	GA
john martin broomall	Start
kenneth william faulkner	Start
william walter wilkins	Start
tucker bounds	C
david beasley	Start
stephen baldwin	C
lgbt conservatism	C
conservative party of new york state	C
joseph franklin biddle	Start
richard nixon	FA
tyler august	Stub
keith esau	Stub
institute on the constitution	Start
james david cain	C
marlow cook	C
trinidad romero	Start
alden anderson	Stub
eddie doucet	Start
wally hicks	Start
redstate	C
melanie sojourner	Stub
william brevard hand	Start
charlice byrd	Stub
pat fordice	Stub
terry carpenter	Start
bobby richardson	C
joe markley	C
david harsanyi	Start
jeff bell	C
alan olson	Stub
don kidd	Stub
mary burrows	Stub
district of columbia republican primary, 2008	Start
david barklage	Start
brian calley	GA
sue everhart	Start
buddy caldwell	GA
virginia foxx	C
jane bryan	Start
vincent boreing	Start
young republicans	GA
patricia godchaux	Start
thomas sakakihara	C
darla moore	C
lawrence eagleburger	C
nathan ballentine	Start
leo marcum	Stub
courtney combs	C
randolph collier	Stub
cassius mcdonald barnes	C
robert campbell reeve	GA
john crowe ransom	C
the new american	C
albert bel fay	C
ken alibek	C
andre cushing iii	Start
barbara alby	Start
larry adams	Stub
scott flippo	Start
jerry sonnenberg	C
marie rader	Stub
charisse millett	Start
joseph bermel	Start
calvin fletcher	B
dana murphy	Start
fran millar	Stub
david hultgren	Start
wayne stenehjem	Start
clel baudler	Start
benjamin harrison eaton	Start
marion crecco	C
dean arp	Stub
pierce cahill	Stub
mark harmsworth	Stub
arthur chapin	Start
desi arnaz	C
talbot peterson	Stub
godless: the church of liberalism	C
justin boyd	Start
frank fitzgerald	Start
earl warren	FA
kris langer	Stub
virginia abernethy	C
ed core	Stub
scott barr	Stub
esteban bovo	Stub
don vigesaa	Stub
gage froerer	C
eric bedingfield	Stub
straw polls for the republican party presidential primaries, 2016	C
roger hedgecock	C
charlie baker	GA
barry loudermilk	Start
knute buehler	Start
doug goehring	Start
pat mcelraft	Start
nephi jensen	Start
jim abeler	Start
william henry bissell	Start
list of paleoconservative organizations	Stub
tom mcclintock	B
republican in name only	C
taylor caldwell	C
marty seifert	C
martin delany	C
abbie carmichael	C
steve heim	Stub
tommy tanaka	Start
ryan osmundson	Stub
dixiecrat	GA
donna cuomo	Stub
bill mescher	Start
larry combest	Start
nicholas kettle	Start
jeff brandes	Start
dianne hamilton	C
prescott freese dennett	Start
roy elson	Stub
charles holland mason	Start
daniel beren	Stub
rick dancer	C
arizona republican primary, 2008	Stub
sebastian giuliano	Stub
bill rehm	Start
david brock	C
united states presidential election in illinois, 2008	GA
david frum	B
felix perez camacho	Start
rufus applegarth	Stub
dennis freeman	C
theblaze radio network	Start
wilford bacon hoggatt	C
george alexander pearre	Start
free congress foundation	Stub
oscar stanton de priest	C
franklin bound	Stub
edwin upton curtis	C
capitol hill club	Stub
jay blossman	C
thyra stevenson	Stub
melissa woodbury	Start
brian duprey	Start
theodore weld burdick	Start
buddy deloach	Stub
mary ann arty	Stub
bill hansen	Stub
stephen hartgen	Start
trace adkins	B
max eastman	C
james abdnor	C
lincoln chafee	GA
irving howbert	C
todd akin	B
william norman grigg	C
virgil effinger	C
robert frantsvog	Stub
bill frist	GA
richard honaker	B
hall lyons	GA
dane eagle	C
roy bernardi	Start
dudley chase denison	Start
the stanford review	C
matthew mechtel	Start
allen raymond	Start
laura bush	GA
brian cresta	Start
gadsden flag	C
nancy johnson	C
george theodore mickelson	Start
carlos camacho	C
trent franks	GA
fanny crosby	GA
ray hutchison	Start
blaine campbell	Stub
don hansey	Stub
dan kaiser	Start
byron boyd	Stub
scaife foundations	Start
byron diman	Start
kevin coughlin	Start
george marquis bogue	Start
byron looper	C
thomas hurley brents	Start
caroline casagrande	C
james bopp	GA
jamie fair	Stub
harry baals	C
george henry chamberlain	Start
firing of shirley sherrod	B
willard warner	Start
william mckinley	FA
swift vets and pows for truth	B
ryan ferns	Stub
lincoln day	Stub
primetime propaganda	C
bob fincher	Stub
lee atwater	C
ira clifton copley	C
john scammon	Stub
ruth dwyer	Start
gary maclaren	Stub
eldon johnson	Stub
john colyandro	Start
mark neuman	Start
endorsements for the republican party presidential primaries, 2012	B
tennessee republican party	C
todd starnes	Start
andrew mckenna	Stub
stephen wright kellogg	Start
james longstreet	C
jeannette wallace	Stub
sada cumber	C
mac collins	Start
leo elthon	Stub
michel claudet	C
dennis daugaard	C
peter norbeck	Start
curtis bean dall	C
beck university	Start
republican party presidential primaries, 1936	Start
susy avery	Start
juba diez	C
robert tingle	Start
leanna brown	Start
liz vazquez	Start
betty ford	GA
michael patrick carroll	C
anna mackinnon	Start
tom hoefling	Start
joe ricketts	C
mississippi republican primary, 2008	Stub
vern buchanan	B
bob heaton	Start
steve antone	Stub
lori grivna	Start
bryant butler brooks	Stub
southern partisan	Start
forrest knox	Start
brian bingman	Start
alice kundert	Stub
george booker	Start
shelby moore cullom	Start
gerald hocker	Start
gerald bennett	Stub
republican party presidential primaries, 2000	B
tirso del junco	C
ron gomez	B
amy stephens	C
steve mcdaniel	Stub
konni burton	C
jim dillard	Start
robert bernard hall	Stub
daniel akerson	C
missy irvin	C
jeff atwater	Start
andy patrick	Start
george cochrane hazelton	Start
richard heath	Stub
mark born	Stub
tea party movement	B
jacob bitzer	C
bruce chapman	Start
judy agnew	C
bill coley	Start
cheri barry	C
don munford	Stub
lynn fitch	Start
matt hatchett	Stub
allen peake	Stub
brereton jones	FA
nic kipke	Start
john chenoweth	Start
henry francis green	Stub
austin blair	C
young conservatives of texas	C
lance clow	Stub
eric eisnaugle	C
barbara cubin	C
lou henry hoover	C
mathew mossburg	Start
wirt yerger	GA
the american conservative	C
eugene gano hay	Start
rita martinson	Stub
maggie brooks	C
mindy finn	C
henrik shipstead	Start
republican moderate party of alaska	Start
susan bitter smith	C
chet pollert	Stub
mark block	C
william emerson barrett	Start
hosea mann	Start
herman tripp	Stub
hiram kinsman evans	Start
howard coble	C
stan bingham	Stub
kay granger	C
henry clay mcdowell	Start
wallis brooks	Stub
theodore tracy fairchild	Stub
mel hancock	Start
newton knight	B
al kurtenbach	Stub
thomas beale dorsey	Start
saul anuzis	Start
ira coleman batman	Stub
tim berry	Stub
list of john mccain presidential campaign staff members, 2008	B
turnaround: crisis, leadership, and the olympic games	Stub
wayne allard	C
randy baumgardner	C
dennis lake	C
charles nelson clark	Stub
archibald roosevelt	C
iris faircloth blitch	Start
we still hold these truths	GA
leslie rutledge	Start
cowboy troy	C
chet upham	GA
sue wallis	Start
kit bond	C
early political career of sarah palin	B
mike huckabee presidential campaign, 2008	FA
riley ingram	C
ezell lee	Stub
mike lair	C
warren petersen	Start
john philo hoyt	C
stephen atkins swails	GA
john sinrud	Stub
robert behning	Stub
charles henry bond	C
rusty crowe	Start
clarence hyde cooke	Start
steve sydness	Stub
david sam	Start
charles clayton	Start
brian sandoval	GA
mark formby	Start
freedomnomics	C
reed demordaunt	Start
tom carlson	Start
republican party of arkansas	Start
thomas beloat	Stub
thomas lilbourne anderson	Start
henry baetz	Stub
duncan baird	C
tyler clark	Stub
jim cobb	Start
charles coiner	Start
1912 republican national convention	C
henry sherman boutell	Start
willis mcduffee	Stub
vern ehlers	C
james holshouser	C
richard burford	C
samuel hitt elbert	Start
henry hazlitt	B
clarence clifton young	Stub
scott mcinnis	B
scott leavitt	Start
myron dossett	Start
william carey jones	Start
massachusetts republican party	C
steve court	Start
carl ford	Start
walter annenberg	C
charles herbert joyce	Start
bill brough	Start
jay neal	Stub
george greer	C
william oswald mills	Start
anna ella carroll	C
salem abraham	GA
herman silver	GA
chuck mcmains	Start
donald evans	Start
george luke smith	Start
curtis halford	Start
pete ricketts	C
daniel sutherland	Start
carly fiorina	FA
shirley chilton	C
united states presidential election, 2008	FA
jana della rosa	C
paul seaton	Start
david schweikert	C
richard randolph mcmahon	Start
ernie alexander	C
paul demarco	Start
mike huckabee	GA
brynhild haugland	Start
oliver bosbyshell	FA
roger cloud	Start
john birch society	GA
steven palazzo	C
allen kolstad	Stub
earl strinden	Stub
mitch carmichael	Start
alexander de witt	Start
rosie berger	Start
steve clouse	Stub
penne percy korth	Start
damon canfield	Stub
buddy cianci	C
council for national policy	C
thomas joseph meskill	GA
orlando hubbs	Start
krusty the clown	FA
john mccain presidential campaign, 2000	FA
american liberty league	C
james hodge codding	Stub
brian boatright	Stub
pamela althoff	Start
stephen horne	Stub
conservative review	Stub
edward beale mclean	C
alfred fontanella	Stub
franklin foil	Start
aaron libby	C
tea party community	Stub
jack swagger	FA
doloris bridges	C
phil bryant	C
encounter books	Start
mary strong kinney	Start
mickey channell	Stub
philip allen bennett	Start
samuel calley	Stub
billy james hargis	B
frank gannett	C
august beversdorf	Stub
russell benjamin harrison	Start
levi newton breed	C
ricky lee cox	Start
amos bronson alcott	FA
herman thorson	Start
dustin burrows	Start
webster davis	Start
sandy cole	Start
joseph blunt	Start
robert jefferson breckinridge	GA
michele reagan	Start
mike kiegerl	Stub
art wittich	Stub
xcel energy center	C
daniela garcia	Stub
john noble goodwin	C
kerry bentivolio	GA
kathy afzali	C
sarahpac	Start
alva smith	Stub
neoconservatism	B
john aloysius green	Start
stormy daniels	GA
karl hess	C
octavius catto	B
jo bonner	GA
evan mecham	FA
charlie condon	C
david manker abshire	C
mary starrett	Start
francis parker yockey	C
mike johanns	GA
malinda blalock	C
peppi bruneau	C
duane mutch	Stub
sean hannity	GA
neoconservatism and paleoconservatism	B
orlando burrell	Start
joseph roswell hawley	C
charles bass	C
bobbie kilberg	C
chuck franco	C
rodric bray	C
skye mcniel	Start
mathew pitsch	C
brenda reneau	C
allan fung	C
michael baroody	Start
john alexander anderson	Start
albert pike	C
1936 republican national convention	Start
jacob dolson cox	FA
enoch foster	Start
richard baxter gilliam	Stub
chuck baldwin	B
jennifer fielder	Start
katrina asay	Stub
hjalmar carl nygaard	Start
george gunther	Start
jordan sekulow	Start
brenda barton	C
kathy hawken	Stub
national federation of republican assemblies	C
republican party presidential primaries, 2016	FA
corinne alsop cole	Start
gary bauer	C
beacon center of tennessee	C
marion bethune	Start
frank gay clarke	Start
virginia federation of tea party patriots	Stub
cecil staton	C
christopher caldwell	Start
steven schiff	Start
blake farenthold	C
arthur alber	C
dan bongino	C
frank avery	Stub
linda combs	C
cindy acree	C
andrea barthwell	Start
ryan maher	Stub
matthew dowd	C
whitelaw reid	C
tom tancredo presidential campaign, 2008	FA
harvey samuel irwin	Start
william henry carter	Stub
eugene millikin	Start
abiram chamberlain	Start
dennis tippets	Stub
contract with america	C
bill pigott	Stub
dan dryden	Start
edmund burke fairfield	C
jerry doyle	C
1872 republican national convention	C
bob deweese	Stub
pat buchanan	GA
jane hague	Start
bloody tubs	Stub
accuracy in academia	Start
julie ellsworth	C
bart rowland	Start
richard and helen devos foundation	Stub
adam andrzejewski	C
david berchelmann	C
dirk kempthorne	GA
bert nettles	GA
brigitte gabriel	GA
layton freborg	Stub
puerto rico republican caucuses, 2008	Start
augustus brandegee	C
kay ivey	C
republican party presidential primaries, 1996	GA
loleta didrickson	Stub
matt michels	Start
national tea party federation	Start
bobby jindal	GA
karl rove	B
california congress of republicans	Stub
james hamper	Stub
frank attkisson	Start
hollywood congress of republicans	Stub
broke: the plan to restore our trust, truth, and treasure	Start
allan larsen	Stub
bill kennemer	Start
ezra taft benson	C
don cheeks	Stub
steve abrams	Start
tom kading	Stub
philip giordano	Start
preston lea	C
kerry white	Stub
sarah brady	C
mark hutchison	Start
idaho republican primary, 2008	Start
sam blakeslee	C
john frank boyd	Stub
shelley hughes	Start
lance horbach	Start
garret hobart	FA
martin harty	Stub
michael balboni	Start
rick brinkley	Start
john cowdery	Start
pledge to america	C
rebecca kubacki	Start
edward buttrey	Stub
phil boots	Stub
cornelia adair	C
gilbert esau	Start
randy avon	Stub
alaska policy forum	Stub
senate conservatives fund	Start
brian kelsey	C
bill graves	Start
cheryl halpern	Start
leo hoegh	C
sara beth gregory	C
lindsey graham	GA
margaret early	Start
shanti gandhi	Start
missouri republican primary, 2008	Start
wesley bailey	Start
harvey sand	Stub
joseph alsop	C
phil batt	C
greg canfield	Stub
howard mason gore	Start
jennifer beck	C
daffney	FA
james mitchell ashley	GA
liz bangerter	Stub
nathan dahm	Start
jack wilson evans	Start
christine erickson	Start
charles aubrey eaton	C
buddy carter	Start
marshall jewell	GA
charles sumner	B
roger milliken	Start
garret graves	C
abraham andrews barker	Start
italia federici	Start
richard elihu sloan	GA
montgomery blair	C
lee qualm	Start
john wayne	FA
thomas mckee bayne	Start
larry kump	Start
erikka lynn storch	Stub
alexander mckinstry	Start
lorenzo burrows	Start
benjamin babock thurston	Start
pat apple	Start
gary aubuchon	Stub
alfred eliab buck	Start
americans for truth about homosexuality	C
institute for advanced strategic and political studies	Stub
robert wilkinson furnas	C
forest harness	Start
scott ecklund	Stub
ruth rowan	Start
dorothy mccullough lee	C
charles hays	Start
allen busby	Start
mike keown	Stub
cindy mccain	FA
stephen wallace dorsey	Start
mick cornett	C
robby wells	C
herman badillo	GA
michael noel	C
steve hogan	C
tom craddick	C
forrest goodwin	Stub
youcut	Stub
gerald cardinale	C
june allyson	B
lou gargiulo	Stub
pat mccrory	GA
jim cawley	C
alan boothe	Stub
kevin bratcher	Start
scott reichner	Stub
wendell willkie	FA
philip erdman	Stub
1976 republican national convention	C
ron christie	Start
todd greeson	Stub
elwood hillis	Start
david vitter	GA
larry darby	C
tom rice	C
rufus barringer	C
oliver henry shoup	Stub
ben meier	Start
bootsie calhoun	Stub
jenna haggar	Start
brett guthrie	C
judith jagdmann	Stub
charles fried	C
students for liberty	B
harvey kenton	Stub
virginia republican primary, 2008	Stub
indiana jones	B
dan eastman	Start
washington ellsworth lindsey	Start
david nohe	Stub
anton fryslie	Stub
larry speakes	C
eleanor espling	Stub
joe read	Stub
james true	C
bill hightower	Stub
cindy frich	Start
orrin bacon	Stub
conde mcginley	C
national republican congressional committee	C
david souter	B
john ashcroft	B
alfred moore waddell	Start
george pataki presidential campaign, 2016	GA
ander crenshaw	C
millicent fenwick	C
loy mauch	Start
jeff delzer	Stub
alfred goldthwaite	Start
stephen wheeler downey	Start
john chafee	C
walter welford	Start
donald burkhart	Start
dick cheney	GA
william loeb iii	B
tom brinkman	C
joel gougeon	Start
pedro agulto tenorio	Start
caleb powers	Start
bill cobey	Start
jonathan bush	Start
stan adelstein	Start
henry mcneal turner	C
barbour lewis	Start
william tudor gardiner	Start
troy balderson	C
jerome epstein	Start
edith bunker	C
robert cornejo	Stub
alice martin	Start
bill devlin	Stub
samuel wilder king	Start
archie bunker	C
front page magazine	Stub
keith hodges	Start
michael kostiw	Start
michigan republican party	B
kathryn jean lopez	Start
joe farrer	Start
georgia republican party	B
adam koenig	Start
jerry falwell	B
william volker fund	GA
robert woods bliss	C
bobby harrell	C
silas seymour	Start
greg evers	C
hank lott	Stub
roscoe pound	GA
roy cohn	GA
randall gnant	Stub
henry shaw briggs	GA
bricker amendment	FA
carlos bonilla	Start
heather wilson	GA
patrick chovanec	B
nathan cooper	Stub
hank williams	GA
henry bodenstab	Stub
lynn dean	C
bud hulsey	Start
orrin dubbs bleakley	Start
samuel ames	Stub
xenophon hicks	Start
richard impallaria	Start
greg childers	Stub
richmond mumford pearson	Start
tony soprano	B
edgar wilson	Stub
jeff cook	Start
walter maddock	Start
saira blair	C
shelley keeney	Stub
luren dickinson	Start
abram colby	Start
george washington emery dorsey	Start
william louis dickinson	Start
jon eubanks	Start
philip augustus marquam	C
sean parnell	C
bud heidgerken	Start
james arness	GA
charlie norwood	C
jason bedrick	Start
1984 republican national convention	C
merita ann allison	Stub
neil chayet	Start
frederick douglass	FA
eugene bookhammer	Stub
deidre henderson	C
james hall huling	Start
horace adolphus taylor	Stub
william luther pierce	GA
brendan doherty	C
brenda burns	Start
jason rapert	C
dan skattum	Stub
carly fiorina presidential campaign, 2016	GA
ernest borgnine	C
chuck damschen	Stub
aubrey mcclendon	GA
daniel ellison	Stub
sam bateman	Stub
matt salmon	GA
jeptha bradley	C
1884 republican national convention	Start
samantha shaw	Start
william hepburn armstrong	Stub
doug hutchinson	C
sarah palin channel	Stub
alan autry	C
kelly keisling	Stub
harlan crow	C
leonard read	C
jacob benton	Start
kip averitt	Start
jeff mullis	Start
brent scowcroft	GA
cathy tilton	Stub
chuck morse	Stub
james franklin battin	Start
paul eggers	GA
sydney emanuel mudd i	C
howard wallace pollock	Start
bob schaffer	C
phil boyle	Start
newton booth	Start
sue sylvester	FA
craig blair	Start
nate bell	C
losing our religion	Start
nelson rockefeller	B
tucker carlson	C
walt disney	FA
harry darby	Start
peter carlisle	C
dan ruby	Stub
shane osborn	Start
frank shakespeare	Start
thomas eugene grady	Stub
rousseau owen crump	Start
samuel blumenfeld	Start
lynette boggs	C
bob cortes	Start
rob bickhart	Start
william harold hutt	Start
lance kinzer	Start
douglas gonzales	GA
larry grooms	Start
gerald hills	Stub
dwight butler	C
benjamin bristow	C
pat hurley	Stub
louise stutes	Stub
stephen steele barlow	Start
tim bivins	Start
a republic, not an empire	Stub
dick randolph	Start
republican party of texas	GA
raymond book	Stub
meredith bordeaux	Stub
bradley foundation	C
kelley paul	C
plaintalk	C
phil ferguson	Start
richard pillsbury gale	Stub
barbara bush	B
john rood	Start
don bowen	Start
michael bileca	Start
meade alcorn	Start
dick ackerman	Start
edward rumely	C
lucy craft laney	Start
leroy blunt	Stub
ben chafin	Start
chris mcdaniel	C
charles djou	GA
zenas beach	Stub
lanhee chen	C
kellye cash	Start
rose wilder lane	C
libby jacobs	Start
chas vincent	Stub
jason buck	Start
gayle mckeachnie	Start
roderick ainsworth	Stub
colby coash	Stub
kathy bernier	Start
rich eychaner	Start
jeffery gifford	Stub
idaho federation of reagan republicans	Start
gil carmichael	GA
chris hart iv	Stub
george henry hoyt	C
trent ashby	C
micah neal	Start
robert zoellick	B
tom murry	Start
gene snyder	Start
sara diamond	Start
patrick mchenry	C
john baldwin neil	Start
david hinkins	C
charles edward kiefner	Stub
sherman adams	C
bruce hanna	Start
tim scott	GA
edmund nelson carpenter	Start
henry wetherby benchley	Stub
james la fayette evans	Stub
thomas philip watson	Stub
melville bull	Start
lester carpenter	Start
wiley scribner	Start
jack crichton	C
chris benge	C
the saturday evening post	C
bonnie huy	Stub
james colgate cleveland	Start
henry mcmaster	C
lane dwinell	Stub
david smith monson	Start
roy blunt	B
jeff backer	Start
joe rand beckett	C
debby barrett	Stub
sumner howard	GA
john shott	Start
ronald reagan	GA
kristen soltis anderson	Stub
kymberly pine	Start
willie talton	Stub
ronda rudd menlove	Start
william miller jenkins	Start
john pope cook	Start
eastern pennsylvania mennonite church	Start
paul ryan	B
david novstrup	Start
the goldwaters	Stub
bob eberle	Stub
robert mitchum	FA
ben quayle	C
gabrielle ledoux	Start
charlotte lane	Stub
kelly flynn	Stub
doug lamborn	C
briggs hopson	Stub
mia love	B
sheffield ingalls	Stub
samuel hinks	Start
galen fox	C
george christopher	C
tom clancy	B
michael folk	Start
phillips lee goldsborough	Start
amata coleman radewagen	C
horace austin	Start
dave albo	C
hamilton rowan gamble	C
jason murphey	C
jerome cochran	Start
denise grimsley	Start
richard gilder	Start
marshall wittmann	Start
elaine harvey	Start
david heaton	Start
rory cross	Stub
sheffield nelson	Start
deborah honeycutt	Start
cissy patterson	C
delvis dutton	Stub
karen hopper	Start
virginia thomas	GA
willis ricketts	C
republican conference secretary of the united states house of representatives	Stub
ellyn setnor bogdanoff	Start
giancarlo ibarguen	C
joseph walton	Stub
jane burgio	Start
andrew brenner	Start
list of latino republicans	C
eric feige	Start
americans for tax reform	C
john faircloth	Stub
bryan avila	Start
arnold vinick	B
phil hermanson	C
sonny landham	Start
ken calvert	C
brooks brothers riot	C
electoral history of bob dettmer	Start
sarah palin email hack	GA
jeanne combs	Stub
lyda green	Start
pat buttram	C
linda sumner	Start
jeff armbruster	Stub
tandy little	C
robert aderholt	C
republican party presidential primaries, 1964	B
david standridge	Stub
boies penrose	C
lynn hettrick	Stub
grant hodges	C
nicholas miccarelli iii	C
mike futrell	C
hugh blackwell	Start
bill shearer	Start
adrian van sinderen lindsley	Start
michael arnone	Start
orion metcalf barber	C
justin smith morrill	C
samuel fessenden	Start
dan liljenquist	C
washington for jesus	C
republican party of louisiana	C
john perry barlow	GA
guy millner	Stub
heulette fontenot	GA
ron estes	Start
albert ritchie	C
tate reeves	C
steve lund	Start
greg hinkle	Stub
zalmay khalilzad	GA
glenn jackson	Start
tommy battle	C
erastus fairbanks	Start
charles decas	Stub
mark scheffel	GA
vernon parker	C
lee cotter	Start
paul hornback	Start
charles william fulton	C
marsha blackburn	B
bill whittle	GA
john albert knebel	Start
straw polls for the republican party presidential primaries, 2012	B
janet rehnquist	Start
bill friend	Stub
american legion	FA
dean burke	Start
bob barker	B
dinah abrahamson	Start
loring coes	C
tom colten	B
henry bellmon	C
utah republican party	Start
simeon eben baldwin	C
wilford brimley	C
george aiken	GA
john aaron rawlins	C
the american enterprise	Stub
caesar antoine	C
scott price	Stub
david bellavia	C
johnny donovan	Start
david weigel	GA
young americans for freedom	C
caroline nilsson troy	Start
mary marvel	C
malcolm forbes	GA
lance carson	Start
prelude to the republican party presidential primaries, 2012	GA
david brumbaugh	C
alfred dockery	Start
jay love	Start
greg bonnen	C
patti anne lodge	Start
jimmy the idiot boy	Start
aaron bean	Start
merle flowers	Stub
aaron fletcher stevens	Start
2000 republican national convention	Start
les merritt	Start
john cyrier	Start
donna mayfield	C
tea party nation	C
john bonacic	Start
lester maddox	C
wayne christian	GA
bill spadea	Start
stephen duprey	Stub
sara taylor	C
raynard jackson	Start
mary mead	C
michael downing	Start
alexander boxwell	Start
arthur bowring	Stub
karl zinsmeister	C
alex monsour	Stub
stephanie malone	C
william claypoole	Stub
james greene hardy	Start
tom mechler	C
leland christensen	Start
mary cheney	C
frank carlucci	C
mary brooks	C
the savage nation	C
thomas deadrick	Stub
westbrook pegler	C
alan arakawa	Start
chuck hagel	FA
kyle johansen	Start
bud otis	Start
jerry klein	Stub
fred girod	Start
ray bodiford	Start
jennette bradley	Start
chester crandell	C
hank huckaby	Start
frontpage magazine	Start
james knowles iii	Start
tom fink	Start
charles frederick barclay	Stub
carol bush	Start
gary johnson presidential campaign, 2012	C
monica youngblood	Stub
jacob brinkerhoff	Start
the atlantic bridge	C
mifflin wistar gibbs	C
leonard garment	Start
bulgarian national front	Start
sayles jenks bowen	Start
ben atchley	Stub
nikki haley	B
liberalism is a mental disorder	Stub
benjamin harrison	FA
lionel hampton	GA
tea party patriots citizens fund	Start
jack hawley	Stub
joseph marcellus mcwhorter	Start
kate obenshain	Start
kathleen sims	Start
dan itse	Start
gary chism	Stub
louis thomas mcfadden	C
edward baumeister	Stub
brian newberry	Start
lydia brasch	Stub
sharon clahchischilliage	Start
stacey dash	GA
culture of corruption	Stub
gentry collins	Stub
matt gaetz	C
sullivan ballou	C
john butler smith	Start
nathaniel cobb deering	Start
palos township republican organization	Start
bobby brantley	Stub
howard sanderford	Start
rita meyer	Start
jim donelon	C
john adams hyman	C
neil parrott	C
rudy boschwitz	Start
carmela soprano	Start
scipio africanus jones	B
kristie fiegen	Start
bobby shows	Stub
tom coburn	GA
chuck blasdel	C
henry browne blackwell	GA
clark jolley	Start
moody currier	Start
mark hatfield	GA
ben hibbs	Start
jerry birmelin	Start
pete dawkins	C
james barroll ricaud	Start
chauncey ives filley	Stub
wilc	Start
james loren martin	Start
bill kintner	C
ernest sands	Start
matt adamczyk	Stub
joseph rainey	C
thomasina jordan	Stub
dan clemens	Start
allison taylor	C
earlene roberts	Stub
jerry climer	B
matt fariss	Start
daniel ullman	C
colorado republican party	C
chris christie presidential campaign, 2016	GA
george de rue meiklejohn	Start
new mexico republican primary, 2008	Stub
august busch iii	Start
john calhoun phillips	Start
doug turner	Start
wayne gilchrest	GA
scott bruun	Start
richard wallach	C
terry gestrin	Start
gary berntsen	C
thruston ballard morton	C
marian bergeson	Start
mary lou retton	C
dick dever	Stub
ferdinand baehr	Stub
mitch holmes	Stub
bettylou decroce	Start
jonathan courtney	Stub
kawika crowley	C
henry regnery	Start
john creswell	C
steve burkholder	Stub
james patton flick	Start
jackson edward betts	Start
tom mcgillvray	Stub
theodore thurston geer	C
jerzy buzek	C
deforest porter	GA
preston doerflinger	Start
jim coburn	Start
gladys pyle	C
leonard liggio	C
dale brandland	Stub
martin madison	Stub
edward clere	Stub
krayton kerns	Stub
rocky fund	Start
obama zombies	Start
rand paul	FA
jay bowerman	Start
rob cornilles	C
rhead story	Start
david bossie	C
charles fuselier	Start
carolyn gilman	Stub
ken hinchey	Stub
charles dorr	Stub
charles curtis	GA
dean cain	C
florida republican primary, 2008	C
michelle caldier	Start
harry blevins	Stub
andrew halcro	C
joel anderson	FA
john all barham	Start
william czar bradley	C
melvin cottrell	Start
john witcher	Start
brent lasater	Start
emma smith devoe	C
ruth briggs king	Start
lewis selye	Start
amazing america with sarah palin	Stub
charles henry dietrich	Start
pat mullins	Stub
jimmy quillen	C
bobby howell	Stub
henry moore baker	Start
country club republican	Start
jack kingston	C
jim aslanides	Stub
larry liston	Start
sam olens	C
chad connelly	Start
henry skillman breckinridge	Start
eldon jacob crull	Start
bob asher	C
david gallegos	Stub
julie finley	Start
polly lawrence	Start
steve gooch	Stub
scott keadle	C
sherman booth	B
james breck perkins	Start
katharine lee bates	C
gordon vance	Stub
randy nix	Stub
the wonderful world of stu	Start
rod chandler	Start
judith foss	Stub
gary stanislawski	Stub
log cabin republicans	GA
matthew klein	Stub
isaiah rynders	B
committee for the free world	Start
daniel russell brown	Start
alon wieland	Stub
silas garber	Start
paul formica	Stub
holly benson	Start
congressional hispanic conference	C
mark trafton	C
rick snyder	GA
the political cesspool	GA
free market fairness	C
paul romrell	Stub
rick ripley	Stub
ernie fletcher	FA
ted yoho	C
andrew maragos	Stub
jim nielson	Start
judy manning	Stub
bonner fellers	C
dan bishop	Stub
bill watts	C
ira hansen	C
jake highfill	Start
joseph jorgensen	Start
hoffman franklin fuller	Start
scott brown	Stub
chuck mcgrady	Start
kirt bennett	C
janel brandtjen	Stub
red forman	C
brian dubie	C
melanie blunt	Start
marvin liebman	C
robert ellsworth	Start
tim neville	Stub
benjamin gratz brown	C
archie alexander	Start
lynn hutchings	Start
fred agnich	C
robert flanagan	Start
florida central voter file	C
janice mcgeachin	Start
john connally	C
deena horst	Start
steve massengill	Stub
jenny beth martin	Start
charles francis adams iii	C
james espaldon	C
clifford joy rogers	Stub
chris wakim	Start
adam badeau	C
stan zemanek	C
margaret flory	Stub
thad cochran	C
greg forristall	C
mason tappan	Start
denise coyle	Start
buck newton	Start
bertram ellis	Start
nelson bunker hunt	C
concerned citizens party	Start
robert ramirez	Start
robert nardolillo	Stub
charles brooks smith	Start
kirk fordice	Start
doug bereuter	Start
patricia morgan	Start
calvin barton	Stub
paul gosar	C
republican jewish coalition	C
karin brownlee	C
flip benham	C
wendy warburton	Stub
virgil goode	GA
curt hofstad	Stub
lynwood ireland	Start
ray tenorio	C
mary franson	C
curt clawson	C
dorothy andrews elston kabis	Start
ambrose kennedy	Start
john ellem	Start
william cleaveland	Start
kelley linck	C
jim talent	GA
john meadows	Stub
clayton fiscus	Stub
nancy masterton	Stub
oliver cromwell applegate	B
amanda pasdon	Start
orville hickman browning	Start
lorraine hunt	Start
margaret barkley	Stub
terry everett	C
wilmer mizell	C
irene shepard	Stub
elisha harris	Start
bert stevenson	C
mario goico	Stub
churchill, hitler and the unnecessary war	C
richard debolt	Stub
jake garn	C
oregon republican primary elections, 2008	C
jack dalrymple	C
barry steven jackson	Start
jeremy faison	Start
dan burton	GA
roy baldwin	Start
edward schroeder brooks	Stub
jon cisky	Stub
cindy denby	Stub
lee bass	C
burton barr	Start
utah republican primary, 2008	Stub
douglas sagers	Start
stan gustafson	Stub
dwight grotberg	C
harry blackmun	C
charles christopher sheats	Start
jean spencer ashbrook	Start
william howard taft	FA
garnett thomas eisele	Start
henry andrus	Start
william romine	Start
neal mccaleb	Start
rosemarie myrdal	Stub
leon griffith	C
larry bellew	Stub
todd heap	C
gene derfler	Stub
laurence curtis	Start
sarah anderson	Start
lewis earle	Stub
josh penry	C
tom george	Start
jason monks	Stub
sue glick	Start
the sean hannity show	C
dana reed bailey	Stub
michael chippendale	Start
parker griffith	C
taking a stand	Stub
harold hellbaum	Start
paul laxalt	C
bill armistead	Start
matt kelty	Start
anthony cannella	Start
goldsmith bailey	Start
stefani carter	Start
livia simpson poffenbarger	Start
kurt wallace	Stub
perry wilbon howard	GA
cyrus william beales	Stub
butch parrish	Stub
forrest mcdonald	C
harry geisinger	Stub
vincent astor	C
republican party of kentucky	C
edgar kelley	Stub
henry william hoffman	Stub
ken buck	GA
larry craig	GA
delpha baird	Stub
john bigelow	C
victor capron	Stub
sandy stimpson	C
danny tarkanian	C
raymond kysar	Stub
emory folmar	C
josh brecheen	Start
1948 republican national convention	Start
david branscum	C
frederick van ness bradley	Start
california republican primary, 2000	Start
alexander mcdonald	Stub
sam raia	Stub
charles cusimano	C
lynn lundquist	Stub
rich buhler	Start
barry goldwater presidential campaign, 1964	B
lori saine	Stub
tom hackbarth	Start
walter dale miller	Start
bob franks	C
patty clancy	Start
sherwood boehlert	C
joe mcwilliams	Start
the occidental quarterly	C
jim demint	GA
dave heineman	C
rich cunningham	Start
john dryden kuser	Start
allen alexander bradford	Stub
beth chapman	C
travis hankins	Start
ken mehlman	B
terrence boyle	Start
mike haridopolos	C
james whitney dunn	Start
alonzo gesner	C
william cohen	C
cy bahakel	Start
kay coles james	C
henry wilson	FA
brad lager	C
janice giegler	Stub
chris simcox	C
millard fillmore	FA
joseph bubba	Start
boake carter	Start
teel bivins	C
dick armey	C
louis brandeis	B
america first committee	C
carmine desopo	Start
alabama republican primary, 2008	Stub
brett lindstrom	B
john lourie beveridge	Start
henry luce	C
phony soldiers controversy	C
charles hall dillon	Start
godlove stein orth	C
jay dickey	C
bill hager	Start
peter boulware	C
tim echols	C
tom kovach	C
steve austria	C
howard hendrick	C
sheryl allen	C
ed morse	Start
steve dallas	C
ron lewis	C
themis klarides	Start
bob hogue	Start
arne carlson	C
karl ohs	Start
joseph aspinall	Stub
fred heineman	Start
isaac latterell	Start
kelly hastings	Stub
michael jarjura	Start
daniel read anthony	C
arthur branch	GA
toni boucher	C
george wuerch	Start
candy ezzell	Start
the overton window	C
doreen costa	Stub
dennis thomas flynn	Start
keith bee	Stub
gayle batt	Stub
charles libby	Stub
kris steele	C
william henry sneed	C
kathy augustine	C
jack kemp	GA
harold hamm	GA
lila sapinsley	Start
christian fong	Start
sinclair weeks	Start
george liquor	GA
mike mazzei	Start
william james connell	Start
joe barton	C
clark gaudin	C
the daily signal	C
texas republican primary, 2008	Start
stacey campfield	B
tony petelos	Stub
margie wilcox	Stub
timothy chad hutchinson	Start
clarence buckman	Stub
randy angst	Stub
david klindt	Stub
raymond moley	Start
william remington	C
garrett mason	Start
julius bodenstab	Start
steve king	GA
phill kline	C
dixie allen	Stub
bruce crippen	Stub
al rantel	C
bob duckworth	Start
barbara craft	Stub
lee edwards	C
sal esquivel	Start
alec poitevint	Start
gary herbert	B
gerhard adolph bading	C
charles andrew howell iii	C
john arthur love	C
tom dent	Stub
george van horn moseley	B
leroy lawrence	Start
sheridan downey	C
phyllis henderson	Stub
mike hayden	GA
victor crist	Start
republican and conservative support for barack obama in 2008	B
edgar carlson	Stub
alphonso hart	Start
fjordman	GA
ron knecht	Stub
jay garner	C
james baker	B
pat gillis	Stub
ben sasse	GA
jim christiana	Start
ralph elihu becker	Start
jeff coleman	Start
charlie huggins	Stub
pete simpson	GA
susan ford	C
craig deroche	Start
lynn luker	Start
leo kieffer	Stub
bruce herschensohn	C
strategery	Start
electoral history of the tea party movement	B
kenny guinn	Start
emmet montgomery reily	Start
william russell smith	Start
northern alliance radio network	Start
kit jennings	Stub
john cusey	Start
debra hobbs	C
arkley frieze	Stub
steven choi	C
chris koster	C
jean boese	C
ed buckham	Start
hugh beaumont	GA
tagg romney	C
abbie cornett	Start
chester hardy aldrich	Start
brett kavanaugh	GA
clark bisbee	Start
terror and liberalism	GA
carl holmes	Stub
vicki marble	C
david pendleton	C
joseph homan manley	Start
michael gerson	C
thomas alberter chandler	Start
ralph okerlund	C
daniel webster comstock	Start
andrew breitbart	GA
glenn beck radio program	C
duane berentson	Stub
electoral history of tom emmer	Start
dustin allard degree	Start
national conservative political action committee	B
dewey jackson short	Start
william poole	C
sean reyes	C
mike chenault	Start
nathan frank	Start
john porter east	Start
republican national convention	C
timothy black	C
jay lucas	Stub
percival proctor baxter	C
janna taylor	Stub
joseph daning	Stub
ruth may fox	C
republican party presidential primaries, 2008	B
john miller baer	Start
phil lovas	Start
buzz aldrin	C
rick santelli	C
tom daxon	C
paul gottfried	Start
seth cropsey	Start
2016 republican national convention	FA
granville barrere	Stub
john brandenberg	Stub
lindsey graham presidential campaign, 2016	GA
doug isaacson	C
sarah palin: you betcha!	Stub
joel hefley	Start
victoria jackson	C
rita clark	Stub
harold lovre	Start
linda baker	Start
reince priebus	GA
david wilkins	C
william henry andrews	Start
jim rubens	Start
daniel short	Start
cynthia dunbar	C
dan lederman	Start
frank guinta	GA
scott frantz	Start
kentucky republican primary, 2008	Stub
james gattuso	C
halsey beshears	Start
gerald brekke	Stub
concerned women for america	C
ohio republican primary, 2008	Start
gary beard	Start
michael goschka	Start
hugo teufel iii	C
rusty glover	Start
renee ellmers	C
krista branch	GA
jim douglas	C
arlen erdahl	C
tom emberton	Start
pat ahumada	Stub
contract from america	Start
mark zachares	Start
thomas wren	Stub
1988 republican national convention	Start
dawson hodgson	Start
shannen doherty	C
leigh larocque	Stub
lawrence hogan	C
chris hagenow	C
terry haskins	C
richard cannady	Start
blaise hazelwood	C
art linares	Stub
douglas hancey	Stub
zehnder confair	Stub
ray jenkins	B
alex decroce	Start
republican party of florida	C
walter johnson	GA
wesley meredith	Start
lonnie hammargren	Start
davis elkins	Start
tom demmer	Start
horace harrison	Start
minnesota republican caucuses, 2008	Stub
steven mascaro	Start
angela perez baraquio	C
louie gohmert	B
daniel littlefield	C
willi schlamm	Start
george wallace	B
clarence emir allen	Start
marsha farney	GA
jason niles	Start
dale dewitt	Start
bill bunten	Start
nickey browning	Stub
john barbee	Start
nehemiah green	Start
theodore heidrich	Stub
james hartness	GA
mark earley	C
leonard dunavant	Stub
jim bunning	C
dave heaton	Start
charles brading	Stub
skip carnine	C
jack breaux	C
rick snuffer	Start
american samoa republican caucuses, 2012	C
independent conservative	Start
james dobson	B
jack ciattarelli	C
wes watkins	C
claudine schneider	Start
we are doomed	Start
mike minter	Start
george eichhorn	Stub
greg brower	C
lawrence kudlow	C
gayle harrell	C
carroll gibson	Stub
thomas scudder page	Stub
judicial watch	B
lee mantle	Start
keith harvey miller	Stub
roy butler	C
debra lee hovey	Stub
doug hoffman	C
john overington	Start
lorenzo crounse	Start
silas reynolds barton	Start
george tisdale hodges	Start
fletcher hale	Start
danny aiello	C
nevada republican party	C
phil amicone	Start
shmuley boteach	C
allen weh	C
sam caligiuri	C
theodore bugas	Stub
steve daines	GA
conrad james	C
james eli watson	Start
claude allen	C
matt jacobson	Stub
marie osmond	C
lawrence jacobsen	Stub
theodore gaillard hunt	Stub
lee heider	Start
henry nicholas bolander	Start
beth fukumoto	Start
sam brownback	B
jimmy pruett	Stub
alf landon	C
sheila butt	GA
william kristol	C
warren green	Start
kevin lundberg	C
timothy johns	Stub
patricia anderson	C
gretchen hoffman	C
paul clement	GA
john howard lindauer	Start
alice mary robertson	C
marc gibbs	Start
leo carrillo	C
steve crisafulli	Start
dean alfange	C
joey hensley	Start
william wallace brown	Start
nicholas schwaderer	Stub
institute for american values	Start
irving berlin	B
national committee to uphold constitutional government	Start
dan douglas	Start
rick murphy	Start
philip gunn	Start
leo glynn	B
matt bevin	FA
greg gay	Stub
bill janis	Stub
the obama nation	B
ronald weiser	Start
reese bowen brabson	C
jesse milton coburn	Start
elsa alcala	Start
blackford oakes	Start
dean heller	B
horace mann towner	Start
jay hammond	C
samuel fleming barr	Stub
alexander robey shepherd	C
citizens for the republic	Start
abraham jefferson seay	Start
tea party review	Stub
randi becker	Start
jonathan paton	C
john kissel	Stub
glen klippenstein	Start
zach dasher	C
leon drolet	C
charles croswell	C
zenith applied philosophy	C
marty gearheart	Start
buddy harden	Stub
dianna duran	C
asle gronna	Start
jamie callender	C
otto reich	C
jim lembke	Start
theron ephron catlin	Start
gordon howie	Start
the integration of theory and practice	Start
william watson mcintire	Start
harlan holleman	C
this is herman cain!	C
andrew jackson bryant	C
warren hardy	Stub
shelley moore capito	GA
bruce alger	C
brian boquist	Start
ilario pantano	C
chris chocola	C
kirk humphreys	C
josiah kerr	Stub
curtis oda	C
hoover league	Stub
amos coggswell	Stub
mike coffman	GA
elizabeth dilling	FA
bill dew	Start
loren fletcher	Start
timothy flanigan	Start
chester bidwell darrall	Start
rachel burgin	Stub
austin knudsen	Stub
amory holbrook	Start
dave bloomfield	Start
charlie janssen	Start
adolph achille gereau	Start
sonny callahan	Start
david catchings dickson	Start
republican party presidential primaries, 1968	B
bennett katz	Stub
alma eldredge	Start
margaret dayton	C
judson hill	Stub
john jacob rhodes	C
guy cordon	Start
an inconvenient book	Start
gayle ruzicka	C
florida election recount	FA
harriet belchic	Start
tom allon	Start
clyde middleton	Stub
dana hanley	Stub
united states presidential election in florida, 2000	C
marion tinsley bennett	Start
trudy coxe	Stub
robert eckels	GA
sean bielat	C
jason conger	C
latimer whipple ballou	Stub
1932 republican national convention	Start
john sitilides	Start
julius curtis	Start
herman cain presidential campaign, 2012	FA
paul shanklin	Start
rick santorum presidential campaign, 2012	FA
my city was gone	Start
katie eyre brewer	Start
josiah begole	Start
kristin maguire	Start
seth lewelling	Start
gaskell romney	Start
eric burlison	C
john feikens	Start
frank lawrence owsley	C
dwayne bohac	Start
sherri smith buffington	C
marco rubio presidential campaign, 2016	GA
james lee anderson	Stub
beth harwell	Start
benjamin champneys	Start
mary lou cowlishaw	Stub
tom corbett	B
bob barr	GA
doug ducey	GA
david halvorson	Stub
elbert guillory	C
audrey meadows	C
condoleezza rice	GA
robert bluey	Start
quin hillyer	C
lottie beebe	C
john marvel	Stub
lincoln loy mccandless	Start
mitch bainwol	Start
isaac parker	GA
arthur woods	C
alexander miller harvey	Start
conservative democrat	B
george rivera	Start
frederick walker pitkin	Start
fob james	C
george anthony dondero	Start
jeremiah wallace baldock	Stub
albert jay nock	C
brent crane	Start
firehollywood	Start
jon costas	C
barbara marumoto	Stub
paul babeu	GA
kim hendren	C
jon keyser	C
janak joshi	Start
wayne faircloth	Start
tom emmer	C
paul coverdell	GA
eddie farnsworth	C
dan debicella	C
tennie rogers	Start
drew perkins	Stub
john suthers	C
policy review	Start
russ mobley	Start
stephanie clayton	Stub
barbara franklin	GA
new york republican primary, 2004	Stub
severn teackle wallis	Start
william ripley brown	Start
horatio washington bruce	B
george vaara	Stub
lavon heidemann	Start
davy carter	Start
eugene eason	C
tony palomo	B
wwtc	C
sarah palin	GA
clarence hoffman	Start
jim jeffords	C
republican party of wisconsin	C
steven rudy	Start
edward gaylord	Start
khaled saffuri	Start
judy lee	Stub
scott bedke	C
james perry conner	Start
william alvord	Start
michael olbrich	Stub
john minnis	Start
benjamin franklin whittemore	Start
dick chrysler	Start
john griesheimer	Stub
janet greenip	C
chuck ahner	Stub
lawrence lockman	Start
jason barickman	Start
thomas robb	Start
wayne allyn root	C
tony dale	C
paula dockery	C
dana childs	Start
steve chabot	GA
chris holbert	Start
mark kirkeby	Start
barry glassman	C
jill upson	Start
garry piiparinen	Stub
mo brooks	B
jimmy eldridge	Start
sawin millett	Start
david blevins	Stub
missouri republican primary, 2000	Stub
sally bolster	Stub
william kretschmar	Stub
mike ditka	C
granville crabtree	Start
guy banister	C
ronnie alting	Start
ken detzner	Start
randy demmer	Start
rich wardner	Start
larry larom	Start
bob rankin	Start
chad fincher	Start
william purnell jackson	Start
oviatt cole	Stub
james burnham	B
kent courtney	B
stace nelson	Start
janet carlson	Stub
mary alice ford	GA
ambrose burnside	FA
the family leader	C
earl ehrhart	Start
todd hiett	C
clare hoffman	Start
tea party caucus	GA
kirsten cohen	C
william henry gleason	C
bourbon democrat	C
bob backlund	B
michael bloomberg	B
missouri republican primary, 2004	Stub
nancy ryles	C
gary flakne	Stub
arnold palacios	Stub
betty lou mitchell	Stub
william bilbo	Start
alexander cameron hunt	Stub
stan bunn	GA
gordon trimble	Stub
bob martinson	Stub
steve dille	Start
the after party: the last party 3	Start
don young	GA
corey brooks	Start
teresa jacobs	Start
conservative party of south carolina	Start
matthew beaton	Stub
peter tali coleman	Start
john hoeven	C
richard nixon presidential campaign, 1968	FA
mike mckell	Start
jay dardenne	B
doug moseley	C
daniel innis	C
dave dravecky	C
federico degetau	C
heather carter	Start
christopher del sesto	Start
pete goicoechea	Stub
andy sanborn	C
kirby wilbur	Start
peter ferrara	C
dave talerico	Stub
milton william shreve	Start
tom gear	Start
theodore roosevelt	FA
david duke	GA
rhode island republican party	Start
bob lake	Stub
ann clemmer	C
jacob furth	FA
jewish institute for national security affairs	C
cornelius newton bliss	Start
oliver hoyt	Stub
lesley vance	Stub
alonzo garcelon	Start
the radio factor	Start
lawrence brainerd	Start
rich crandall	Start
george eskridge	Start
robert schadler	Stub
eddie briggs	Start
karen handel	GA
webb franklin	Start
roswell farnham	Start
casey cagle	C
randy pullen	Stub
joseph grant beale	Stub
ron george	C
fraser bullock	Start
james barker edmonds	Start
charlie daniels	C
walter boasso	C
walt havenstein	C
dirty sexy politics	Start
jeremiah denton	C
bob goodlatte	GA
andrew jackson donelson	B
peter cianchette	Start
ray mckinney	C
anson morrill	Start
henry burns	GA
jon kyl	GA
samuel atherton	Stub
murray rothbard	B
jean hunhoff	C
francis preston blair	C
john mccain presidential campaign, 2008	B
howard sutherland	Start
gilbert bettman	Stub
laurie rushing	Start
valentine rausch	Stub
rolland hatfield	Stub
frank degroat	Stub
republican state leadership committee	Start
bob richards	C
thomas edward campbell	C
neal blaisdell	C
gordon mydland	Stub
robert letourneau	Stub
david addington	B
the american interest	Start
gene autry	C
american indian model schools	B
roscoe conkling	GA
christopher barden	C
louis blessing	Stub
jon sonju	Stub
jeb stuart magruder	C
gordon hensley	Stub
jim sorvillo	Start
alan doane	Stub
donald kagan	C
angela mcglowan	Start
augustin reed humphrey	Start
arthur gratias	Stub
ted bundy	FA
john morse haydon	Stub
bay buchanan	C
elza jeffords	Start
vincent buys	Stub
joe carollo	Stub
james glenn beall	C
joe skeen	Start
max rafferty	C
nimi mcconigley	Stub
jon becker	Stub
verdell jackson	Stub
job adams cooper	Start
josiah carter	Start
1916 republican national convention	C
hillsdale college	FA
thomas herlihy	Start
betsy devos	B
jamie glazov	Start
steven neville	Start
karen floyd	C
joseph gurney cannon	C
the new criterion	C
susan gould	Stub
thomas william humes	C
rowlie hutton	Stub
ben albritton	Start
jehu baker	Start
edwin russell durno	Start
james haffey	Stub
herman welker	C
mark holsten	Stub
lem overpeck	Stub
mike simpson	C
roger chamberlain	Start
lathrop burgess	Start
loren leman	C
north dakota republican party	Start
pete constant	Start
elaine chao	GA
rush clark	Start
sig rogich	C
carmine boal	Start
harry bowser	Stub
francis harrison pierpont	C
jaime herrera beutler	GA
don hineman	Stub
cornelius leary	Stub
kerry conley	Stub
wilkes angel	Start
chic hecht	C
ernest willard gibson	GA
john hope anderson	Stub
gary staples	Stub
willis sweet	Start
mike duncan	C
christopher burnham	Start
orlando allen	Stub
anitere flores	C
bryan baptiste	Start
bruce dammeier	Start
paul lepage	GA
dwayne alons	C
andrew natsios	C
leslie nutting	Stub
nancy boettger	Stub
american college of pediatricians	GA
american freedom party	C
richard cebra	C
mel bradford	C
american independent party	GA
gregory lavelle	Start
oscar hauge	Start
john warford	Stub
paula boland	Start
bob roses	Stub
anne armstrong	Start
vermont republican primary, 2008	Stub
vic gilliam	Start
reagan dunn	Stub
colleen burton	Start
arnold olsen	Start
doris goodale	Start
liston barfield	Stub
carol hanson	C
hugh roy cullen	C
frederick steiwer	C
albinus nance	C
morgan bulkeley	C
jeff nesset	Stub
george washington blanchard	Stub
dan quayle	C
1888 republican national convention	Start
tim knopp	Start
ron paul presidential campaign, 2008	FA
winning the future	Stub
david gaither	C
andy mayberry	C
debbie lesko	Start
tom sansonetti	Start
shane martin	Start
the case against barack obama	C
alfred alspach	Start
whitney anderson	Start
william morris stewart	C
jack coghill	Start
emmett hanger	Start
everett mcleod	Stub
ira hobart evans	C
sid dinsdale	Start
robert vernon denney	Start
tom crowson	Stub
bill clements	C
irene baker	Start
abner coburn	Start
robert moffit	Start
edward southard	Stub
answers for americans	Start
tom pauken	C
jeffrey hart	Start
saggy tahir	GA
jan collins	Start
thomas jefferson majors	Start
neal boortz	C
tom copeland	Start
tunis campbell	Start
drew darby	Start
bill herbkersman	Stub
rick perry presidential campaign, 2012	B
jonathan shell	Stub
lane jean	Start
the laura ingraham show	C
steve nunn	C
alexander asberry	Stub
everett dirksen	C
hiram rhodes revels	C
pat garofalo	Start
thomas russell bowden	Stub
samuel ryan curtis	C
minnie lou bradley	B
thom collier	Stub
frank donatelli	Start
john oliver creighton	C
robert mills grant	GA
kay mciff	C
abdul tawala ibn ali alishtari	Start
burnham martin	C
jim gotto	Start
kenny marchant	Start
bill caul	Start
marcus lawrence ward	Start
john alexander brewster	Start
niles searls	GA
harold peterman	Start
john hanson farquhar	Start
manchester boddy	C
cathy dahlquist	Stub
george shiras iii	Start
william noble andrews	Start
willis carto	C
thomas dayley	Start
sue myrick	C
harrison kelley	Stub
tom dermody	Stub
john denison baldwin	C
connie binsfeld	Start
ada fisher	GA
henry watkins allen	C
ralph metcalf	C
carlos gutierrez	GA
hubert work	Start
henry bristow	Stub
jay buhner	C
artur davis	GA
mark curran	Start
paul hanneman	Stub
danny verdin	Start
bert brackett	Start
dolores gresham	Start
luther strange	C
nicholas ford	Start
stuart epperson	Stub
greg snowden	Stub
benjamin white norris	Start
bob gunther	Start
kerry benninghoff	Start
peter billingsley	C
kathryn wasserman davis	C
arliss sturgulewski	Start
james vernon smith	Start
gerald rudolff ford	C
catherine hanaway	GA
anastasy vonsyatsky	C
conservative victory	Stub
bert mizusawa	C
henry zuber iii	Stub
marshall parker	Start
otto amen	Stub
larry george	C
mary lou slinkard	Start
william broomfield	Start
john flittie	Start
slouching towards gomorrah	Start
jeff landry	GA
richard achilles ballinger	C
paul angstadt	Stub
jason priest	C
moses bull	Stub
wilt chamberlain	B
kurt daudt	C
curtis lemay	B
paul espinosa	Stub
paul busiek	Stub
earle mccormick	Start
sideshow bob	FA
joe heck	GA
hal daub	Start
icons of evolution	GA
jay houghton	Start
clark kauffman	Stub
vic kohring	Start
ellen bard	Start
warren garst	Start
don shooter	Start
united states virgin islands republican caucuses, 2012	C
hip hop republican	Stub
scott cyrway	Start
david osborne	Start
sewell avery	C
jo ann emerson	C
dutch mantel	GA
joel cheatwood	Start
scott munsterman	C
murray ryan	Stub
the terrible truth about liberals	Stub
scott baugh	Start
alvin hawkins	C
christopher coutu	B
marvin childers	Start
sidney dean	Start
conservative punk	Stub
gayle kingery	C
cynthia lummis	C
donna campbell	C
ted stevens	GA
kent lambert	C
john franklin fort	Start
zachary cook	Start
lenny mcallister	Start
bill donohue	B
joe hutter	Stub
yvonne brown	C
delbert hosemann	Start
john gaston grant	Start
joshua bolten	C
cal holman	C
joseph henry kibbey	GA
mackinac republican leadership conference	Start
edward weidenfeld	Start
ed schafer	C
oregon republican party	B
carole murray	Start
bruce chandler	Stub
james william marshall	Start
william steger	C
ed royce	GA
ron paul	GA
john bertrand conlan	Start
john watson barr	Start
charles calvin bowman	Start
patrick flood	Start
adam kwasman	Start
jeff farrington	Stub
tom goodson	Start
john wilbur dwight	Stub
shawn steel	Start
jim geringer	Start
bob deuell	C
let freedom ring: winning the war of liberty over liberalism	Start
guy carbone	Stub
bob cohee	Start
william russell willcox	C
sara evans	B
antonio giarrusso	Start
tim burchett	C
hans borchsenius	Start
chuck fleischmann	C
john dos passos	C
gary johnson	GA
indiana republican party	C
ida ballasiotes	Stub
randy barnett	C
republican unity coalition	Start
carl gunderson	Start
leon ames	C
united states house of representatives republican leader election, 2006	Stub
william belter	Stub
cyrus aldrich	Start
peter edgecomb	Start
david martin baker	Stub
charles delano	Start
george holding	C
matthew scully	C
fusionism	C
john coolidge	C
peppy martin	C
cornelius cole	Start
dave pankonin	Stub
galen higdon	Stub
bob wooley	Stub
chris buttars	C
george keiser	Stub
steve hickey	Start
jack donaghy	FA
jude hofschneider	Start
elizabeth price foley	C
linda schrenko	Start
randel christmann	Start
hugh mcculloch	C
joshua chamberlain	C
thelma drake	Start
norris cotton	Start
gary sukut	Stub
sidney clarke	Start
buddy roemer presidential campaign, 2012	C
ray mcberry	Start
fred thompson presidential campaign, 2008	GA
bob inglis	GA
james colt	C
sydney emanuel mudd ii	Start
shandi finnessey	GA
conrad hilton	C
jim gilchrist	C
marshall coleman	Start
rick rydell	C
grant conard	Stub
the politically incorrect guide to science	Start
resignation of sarah palin	C
john gilfillan	C
thomas boles	Start
reed budge	Start
anne hajek	Start
jeff fortenberry	C
bill cadman	C
1876 republican national convention	Start
nolan mettetal	Stub
mary ann hanusa	Start
cedric lee hayden	Stub
jackie gleason	B
lisa de pasquale	Start
emil anneke	Stub
troy mader	Start
william wildman campbell	Stub
sydney anderson	Start
christopher ottiano	Start
thomas rivera schatz	C
patricia acampora	Start
thom goolsby	C
gary kreidt	Stub
gary cammack	Stub
glenn andrews	Start
ruby hooper	Start
clark ervin	Start
elise hall	Start
clarence morley	Start
justus dartt	Start
gary becker	C
james burkee	Start
john ensign	C
michael peroutka	C
bill bolling	C
curt bromm	Stub
rodney anderson	Stub
merv riepe	C
matthew ricketts	C
henry lippitt	Start
george whitman hendee	C
max yates	Stub
trevor blackann	Stub
frank charles bunnell	Start
virginia degravelles	C
zachariah chandler	C
john clayton allen	Start
william francis nichols	Start
david rust	Stub
david meade	Stub
math dahl	Start
kelly downard	Start
tony blankley	C
carroll meins	Start
pete pirsch	Start
larry forgy	Start
scott baio	C
ozra amander hadley	Start
tommy stringer	Stub
preston parks	Stub
wasilla, alaska	GA
wendy horman	Stub
governor james devlin	B
mary liz holberg	Start
young boozer	Start
jerry regier	C
douglas mckay	C
keith bulen	C
republican leadership council	Start
charles durkee	Start
dennis nielsen	Start
sheila roberge	Stub
robert kagan	C
fred gustus johnson	Start
aretas blood	Start
sharon block	Stub
glenn beck	GA
elmer holmes bobst	Start
roger jepsen	Start
vicky hartzler	C
conrad appel	Start
joanne herring	C
dan seum	Stub
troy king	C
bo callaway	C
henry clay evans	C
mark chelgren	Start
les brownlee	Start
william rehnquist	B
verne duncan	C
richard kinder	C
jerry bruckheimer	B
rick bertrand	Stub
cresent hardy	Start
james bintliff	GA
cory gardner	GA
freedom caucus	C
clay ford	Start
william kassebaum	Stub
moon griffon	GA
cheney ames	Start
joseph azzolina	Start
mary church terrell	C
cheryll heinze	Stub
gary emineth	Start
chester earl merrow	Start
wayne krieger	Start
bill stoltze	Stub
todd courser	C
hiram gill	B
joyce maker	Stub
dennis milligan	Start
woody burton	Stub
mark berg	Stub
lawrence coughlin	C
charles aberg	Stub
john bell williams	C
doug brannon	Stub
hispanic and latino conservatism in the united states	B
edith bullock	Start
helen delich bentley	C
john light napier	Start
waino hendrickson	Start
herbert melville hoxie	Start
linwood clark	Stub
judson gilbert ii	Start
husein cumber	C
roscoe bartlett	GA
ric flair	B
elijah babbitt	Stub
chris walters	Start
shane cultra	Stub
joey brush	Stub
brandt hershman	Start
jeff dial	Start
republican party presidential primaries, 1976	C
charlie crist	GA
dave carlin	Stub
glenn moniz	Start
william farrand prosser	Start
jared benson	Stub
tim lee carter	Start
jan brewer	B
wes cooley	C
nathan kimball	C
jack herrity	Start
jennifer carroll	C
list of 2006 human rights incidents in egypt	B
brad courtney	Start
alan bond johnson	Stub
lormong lo	Start
leroy smallenberger	Start
bruce bartlett	C
oliver ames	Stub
clare farragher	Start
eugene siler	Start
janet vestal kelly	Stub
mike ertel	Start
gerald gay	C
robert deniston hume	GA
treaty of fifth avenue	Start
butler ames	Start
victor rosewater	Start
results of the republican party presidential primaries, 2012	GA
jerome corsi	B
congressional institute	B
paul hardy	C
donald crane	Stub
roger sherman baldwin	Start
nadia yassir	C
shirley adele field	Start
jim inhofe	GA
cary condotta	Stub
rufus bullock	C
george washington carver	B
bob corker	GA
dennis carpenter	Stub
drake edens	Start
vice presidential candidacy of sarah palin	B
roger ream	Start
mike greear	Stub
herman carl andersen	Start
west virginia republican party	C
clifford mcintire	Start
national review	GA
henry failing	GA
bruce tutvedt	Stub
tommy casanova	C
pat gray	Start
michael ramone	Stub
brian bilbray	C
elmer burkett	Start
rick cessar	Stub
lindsay applegate	GA
united states virgin islands republican caucuses, 2008	C
jake knotts	C
joe nosef	Start
thomas holliday hicks	C
phineas hitchcock	Start
jonathan dismang	Start
cliff pirtle	Stub
marriott henry brosius	Start
kurt moylan	Stub
jim bob duggar	C
michael farris	Stub
hank hill	C
james meredith	C
bill bowerman	C
chip baltimore	Start
kim hammer	Start
charles crookham	C
william stiles bennet	Start
will longwitz	Stub
leo berman	C
henry alexander baldwin	C
jim whitaker	Start
lincoln and liberty	Start
michael bilirakis	Start
alabama policy institute	C
american family association	GA
the privileged planet	Start
kathleen donovan	C
constance berry newman	C
charlie bethel	Start
warren booth burrows	Stub
rita inos	B
talk radio network	GA
ron paul presidential campaign, 2012	B
bob ehrlich	C
gary deffenbaugh	Start
geoff davis	GA
owen hill	Start
david hogg	Stub
rob cook	Stub
suzanne miles	Start
stan aronoff	Start
deborah hendrix	Start
alonzo conant	Start
richard kleindienst	Start
mary kane	Start
jake files	Start
timeline of modern american conservatism	FA
john clerkin	Stub
harvey fillingane	Stub
kenneth mapp	C
thomas alfano	Start
the cornell review	C
dick roeding	Stub
pat marsh	Start
george cookman sturgiss	Start
horace hildreth	Start
ray hadley	C
green currin	Start
ralph kilzer	Stub
independent american party of nevada	Start
robert edward edmondson	C
robert auth	Start
royd chambers	Start
barbara comstock	C
tom arpke	Stub
william warren barbour	C
duncan hunter presidential campaign, 2008	GA
taylor barras	Start
cass ballenger	C
william claiborne owens	Start
michael fedele	Start
bill landen	Stub
shawn lindsay	Start
mike faulk	Stub
frank minis johnson	C
keith fimian	GA
heinz hofschneider	Start
eric buckson	Stub
lesil mcguire	C
peggy bennett	Start
paul cellucci	C
john barge	Stub
kingdon gould iii	GA
lauch faircloth	Start
ralph hall	GA
nicholas felice	Start
princeton tory	C
ted klaudt	C
mike sottile	Stub
markberg	Stub
jenny sanford	C
laura brod	Start
edmund hillestad	Stub
taxpayer march on washington	GA
lawrence lindemer	Start
human events	GA
firing line	Stub
donald schaible	Stub
jane cunningham	Start
bill sample	C
branko radulovacki	C
wells spicer	C
doug cloud	Start
glenn gruenhagen	Start
the national interest	Start
alexander oswald brodie	C
john george nicolay	C
dave munson	Start
glen froseth	Stub
margaret sitte	Start
john van mcduffie	Start
debe terhar	Start
rick perry presidential campaign, 2016	GA
bloody monday	C
norby chabert	C
william boyce thompson	C
absalom willis robertson	C
dawn marie addiego	C
united states presidential election, 1964	C
albert mcintire	Stub
donna sheldon	Stub
fred hall	Start
republican national hispanic assembly	C
felix zollicoffer	FA
jim broyhill	Start
republican party of iowa	C
alfred conkling	Start
gopac	Start
myra crownover	C
stan kroenke	C
harold lord varney	Stub
republican national coalition for life	Stub
walter reichert	Stub
tom luna	C
cynthia davis	C
william howard taft iv	C
john adams gilmer	Start
1860 republican national convention	GA
darrell bolz	Start
cordelia scaife may	Start
holt collier	Start
jim bradford	Start
alfred kohlberg	Start
john lim	C
republican party of new mexico	C
sue boldra	Stub
julie mayberry	Start
curt meier	Stub
charles burnham	Stub
kenneth adelman	C
randy boehning	Start
william crutchfield	C
les seiler	Stub
carroll leavell	Start
fuller harding	Start
lou barletta	C
phil crane	C
butch otter	C
john jacob rhodes iii	Start
lenn hannon	Stub
nancy stiles	Start
kevin gentry	C
electoral history of sarah palin	Stub
pete kott	Start
jeff flake	FA
tod robinson caldwell	Start
everett bidwell	Start
marion milne	Stub
thomas carskadon	Stub
tim corder	Stub
jimmie don aycock	Start
thomas rivers	Start
1940 republican national convention	C
al lance	Start
ferrell haile	Start
chicago tribune	FA
american conservative union	C
dan fabian	Start
chauncey sparks	C
joseph perry bradbury	Start
phillip lowe	Stub
elmo smith	Start
erik simpson	Stub
capital research center	C
clark barnes	Start
tim schneider	C
zenas work bliss	Start
nelda speaks	Start
zuhdi jasser	GA
emerson hammer	Stub
jean inman	Stub
tom cotton	GA
nancy montanez johner	Start
lawrence di rita	Start
nancy cassis	Start
bill hendon	Start
clarke hogan	Stub
henry thomas helgesen	Start
bill barrett	Start
herman otten	Stub
dwight loftis	Stub
danny hamrick	Start
hal bernson	B
sander rue	Start
charles edward clark	Start
phil gingrey	C
david archibald harvey	Start
warren rudman	C
david towell	Stub
george henry boker	C
william herbert hunt	Stub
roy hollandsworth	Stub
odon guitar	C
jesse benton	GA
henry burk	Start
edward daniels	Start
walter brennan	C
michael abel	Stub
gordon canfield	C
hart benton holton	Stub
clifford bayer	Start
john boynton philip clayton hill	Start
terry wanzek	Stub
alexander bullock	GA
john howard pyle	Start
good tidings and great joy: protecting the heart of christmas	Stub
bernard healy	C
al cardenas	Start
jonathan clarkson gibbs	FA
robert gleason	C
rex armistead	B
steve dehler	Stub
ron griggs	Start
washington king	Stub
hudson holliday	Start
milton friedman	GA
national federation of independent business	Start
william wirt culbertson	Stub
pat mcgeehan	Start
bill berryhill	Stub
heidi gansert	Start
gordon klingenschmitt	C
robert kingston scott	C
mead treadwell	GA
guam republican caucuses, 2012	C
scott walker presidential campaign, 2016	GA
hill blackett	Start
tom horner	Start
ole hanson	C
kelli sobonya	Stub
new hampshire republican state committee	B
nancy barto	Start
kenneth brandt	Stub
vince callahan	Start
frank clague	Start
jeb bush presidential campaign, 2016	B
alma bridwell white	GA
harry cato	Start
kristopher crawford	C
benjamin stephen hooper	Stub
george cretekos	Start
thompson benton ferguson	Start
bernie herpin	Start
lawerence denney	Start
ron arthun	Stub
1956 republican national convention	Start
casey guernsey	C
winchel bacon	B
jonathan bydlak	C
jon porter	C
jim dotson	Start
bob marks	Stub
sam graves	C
dave camp	C
christa calamas	Stub
kevin madden	GA
anson burlingame	C
greg brannon	C
tom mccall	C
the death of the west	Start
reynell coates	Start
mae beavers	C
morgan philpot	Start
john gardner coolidge	Stub
jendayi frazer	C
david henry mercer	Start
lane carson	Start
nicholas egbert knight	Stub
nate gentry	Start
martha mcsally	GA
karilyn brown	Start
rick hendrick	C
mike fallon	C
thomas peter akers	Stub
elisabeth hasselbeck	GA
william napoli	Start
david lifferth	C
merrill cook	C
clair burgener	Start
sanji abe	C
deliver us from evil: defeating terrorism, despotism, and liberalism	C
jase bolger	C
michael brodkorb	C
julian garrett	Stub
peg luksik	Start
pat delany	Start
randy feenstra	Start
walter evans edge	GA
john hagans	Start
owen donohoe	Stub
anne donahue	C
janice rogers brown	C
oakes ames	C
angela corey	B
felix morley	Start
curt friesen	C
republican party of minnesota	C
ned flanders	FA
betty babcock	Start
david sessions	Stub
robert frederick bennett	Start
paul coble	C
lisa carlton	Stub
ross rizley	Start
owen drake	Stub
oscar richard hundley	Start
republican majority for choice	Start
walter conahan	Stub
rightnow women	Stub
janine turner	C
jo ann davis	C
jeremy gillam	Start
john nance garner	C
karen krebsbach	Stub
christian liberty party	C
kasha kelley	Stub
fletcher bowron	C
george sherman batcheller	C
trevor drown	C
sean tindell	Start
dick brewbaker	Stub
john decamp	C
cale case	Start
dennis powers	Start
larry bomke	Start
wayne pettigrew	Stub
nan baker	Start
nick ayers	C
max burns	C
justin harris	C
isaac dabbs	Start
vincent carter	Start
republican governors association	Start
nancy mace	C
stuart ingle	Stub
jeff kruse	Start
kaleo moylan	Start
george albright	Stub
stephen humphrey	Stub
preston bynum	C
john rarick	C
gus bilirakis	C
tim lahaye	B
lewis billings	Start
lloyd larsen	Stub
david blanchard	Stub
pete livermore	Start
charles douglas iii	Start
ricky long	Stub
dick posthumus	Start
powell clayton	C
marc kaschke	Stub
jeffrey paul hillelson	Start
nancy riley	C
frank hanighen	Start
richard cornuelle	C
brett geymann	C
margretta dietrich	Start
thomas jenckes	Start
franklin fairbanks	Start
edward gurney	C
stephen barrar	Start
steve burguiere	Start
clinton lesueur	Start
david kellogg cartter	Start
american principles project	C
richard taylor jacob	Start
kathleen wilcoxson	Start
howard alexander smith	C
fenimore chatterton	Start
judd gregg	GA
ralph emerson bailey	Stub
michigan republican primary, 2008	Start
dennis callahan	Start
lois landgraf	Stub
greg aghazarian	Start
jd alexander	C
terry kilgore	Start
llew jones	Stub
page belcher	Start
mark fahleson	Start
richmond pearson	Start
leon curtiss	Stub
mickey edwards	C
rowland louis johnston	Stub
larry cretul	Start
charles elwood brown	Start
ed derwinski	C
harold hitz burton	C
bill whitmire	Stub
matthew gagnon	C
esperanza andrade	Start
vincent candelora	Stub
lisa meier	Stub
michael durant	C
victoria seaman	Start
robert mardian	C
stephen shadegg	GA
southern agrarians	C
cyrenus cole	Start
burke jackson	Stub
greg habeeb	C
don samuelson	C
justin everett	Start
cheri gerou	C
judy burges	Start
steve godsey	Start
grace coolidge	C
pedro celis	C
david demarest	Start
eben pomeroy colton	Start
michael late benedum	Start
levi boone	C
edwin walker	B
ways that are dark	FA
mike friend	Start
republican party presidential primaries, 1972	Start
david horowitz	B
linda kay manns	Start
don tripp	Start
virginia paul holm	Stub
katcho achadjian	C
jack eckerd	C
charles graddick	Start
daniel mccay	C
randall shedd	Stub
larry mcdonald	GA
glenn coffee	C
herman cain	GA
ron jorgensen	Start
dan nordberg	C
bruce breslow	Start
rick berg	GA
ellsworth foote	Start
regnery publishing	C
clare boothe luce	B
terry dempsey	Start
jim guest	Start
tim hutchinson	C
laurence silberman	GA
dan druen	Start
jeffrey butland	Start
scotty campbell	Start
walter hundley	Start
deb fischer	C
hunt downer	C
jeran akers	Start
dawn gibbons	Start
charles blahous	Start
cathy giessel	GA
kathy byron	C
john robitaille	Start
paul broun	GA
douglas baily	Stub
blake curd	Start
christopher bateman	C
james john	GA
herman rattliff	GA
al smith	FA
harry stewart new	Start
keith ablow	C
oswald garrison villard	C
andrew bolt	C
josiah grout	C
john elway	B
national council for a new america	Stub
history of the united states republican party	B
matt dollar	Stub
otto passman	GA
doctors for disaster preparedness	C
george argyros	C
sid flanagan	Stub
philemon bliss	Start
dale folwell	B
al adinolfi	Stub
orrin hatch	GA
oscar dunn	C
don caruth	Stub
pamela cahill	Stub
richard viguerie	C
steven brunk	Stub
harold see	Start
paul bandy	Start
alan novak	Start
carlos bilbao	Start
simon cameron	C
alfred cate	C
nathaniel head	Start
tom del beccaro	Start
sue wilson beffort	C
edwards barham	C
joel abromson	Stub
paul fannin	C
jim reese	Start
lynn bechler	Stub
wendell erickson	Start
sean fieler	Start
liz cheney	GA
mike erickson	C
erik helland	C
bamboozled: how americans are being exploited by the lies of the liberal agenda	Stub
allen mcneill	Stub
pearl carter pace	Start
list of politicians affiliated with the tea party movement	B
fred hemmings	C
tom gallagher	C
intercollegiate studies institute	C
sherman everett burroughs	Start
doug broxson	Start
ronald coase	C
ernest angelo	GA
don gaetz	C
scott cordelle bone	Start
lewis lehrman	C
sam aanestad	Start
domenick dicicco	Start
howard baker	C
sam fiocchi	Start
frank keating	C
elisha winfield green	C
frank couzens	C
josiah willard gibbs	FA
bruce frohnen	Start
cathrynn brown	Start
luke coffey	Start
larry crouse	Stub
marc racicot	C
todd boulanger	Start
broughton harris	C
mike callton	C
todd lakey	Start
pearl bailey	C
patrick daniel norton	Start
dan claitor	GA
wharton barker	Start
duane clarridge	C
wally herger	C
edward nathan pearson	Start
guilford wiley wells	Start
republican main street partnership	C
john bugas	FA
bill mcilvain	Stub
center for arizona policy	C
john hutson	C
michael baumgartner	C
suzanne bassi	Stub
john bennett ramsey	C
samuel swinfin burdett	Start
claremont review of books	Start
nicholas boldyga	Stub
danny burgess	Start
sam mims, v	Stub
mike ryhal	Stub
chuck haytaian	Start
charles cleveland convers	Start
george buxton	Stub
theodore frelinghuysen singiser	Start
leonard christian	Stub
republican party presidential primaries, 1992	C
eldon nygaard	Start
chris langemeier	Stub
charles memorial hamilton	Start
chuck devore	C
barbara barrett	Start
scott tipton	C
frederick holbrook	Start
rob bruchman	Stub
americans for a republican majority	Start
caleb mccarry	Start
william david blakeslee ainey	Start
octaviano ambrosio larrazolo	C
republican party presidential primaries, 1988	B
dick wadhams	Start
aimee winder newton	Start
andrew ciarfardini	Stub
ron maurer	Start
jacob harold gallinger	C
bob nicholas	C
hugh gregg	Start
gary hayzlett	Stub
loveland munson	Start
jason stverak	Stub
steve may	C
gene therriault	Stub
frank farrar	Start
carmine mowbray	Stub
ed bethune	B
justin amash	C
antonia novello	C
2008 republican national convention	FA
les guice	Start
james erwin	Stub
ronald crimm	Stub
ray schnell	Stub
ted gunderson	C
james settelmeyer	Start
ralph austin bard	C
russell kirk	C
rod hamilton	Start
rod paige	C
holly coors	Start
drew bowers	C
stephen handy	C
mitt romney presidential campaign, 2008	GA
max maxfield	GA
louis bromfield	Start
randy stufflebeam	Start
elwood bruner	C
john cooksey	Start
americans for prosperity	FA
jouett shouse	C
ernie banks	GA
the republican war on science	C
cleve loney	Stub
nyla murphy	Stub
lewis strong clarke	Start
william bendix	C
michelle gray	C
george turman	Stub
west virginia republican caucuses and primary, 2008	C
seelig wise	Start
nancy brinker	B
gresham barrett	C
nucky thompson	GA
independent republican party of south carolina	Start
frank knox	C
perkins bass	Start
ray bolger	C
ron amstutz	Start
kris hansen	Stub
jay van andel	Start
joseph edgar brown	Start
william samuel booze	Stub
michael deaver	C
bull connor	C
william gackle	Stub
chuck gatschenberger	Start
franklin ellsworth	Stub
jeb bradley	C
john macgovern	Start
greg heartsill	Start
jan angel	Start
randall head	Stub
stephen coburn	Stub
norris wright cuney	GA
earl christensen	Stub
the professors: the 101 most dangerous academics in america	C
betty olson	Start
allen icet	C
conrad burns	B
south park conservatives	Stub
rocco clarizio	Start
kim holmes	C
connie mccready	Start
calvin cowgill	Stub
david sypolt	Start
alan redfield	Stub
william paine lord	Start
glenn beck program	B
erwin cain	Start
the best democracy money can buy	Stub
judy baar topinka	C
zora neale hurston	B
robert stell heflin	Start
bob calhoun	Stub
republican study committee	C
rubel phillips	B
frank pease	Stub
bill callegari	GA
scott ashjian	GA
john danforth	C
chuck red ash	Stub
free republic	GA
carolyn blanchard allen	Stub
cedric ross hayden	Stub
joey hood	Stub
mark mickelson	Start
josiah bailey	Start
larry bucshon	C
niger innis	Start
angelo carpenter	Start
k street project	C
juan babauta	C
van vo	Stub
charles krauthammer	GA
ohio republican party	C
frederick essen	Stub
charles colson	B
basil marceaux	C
tony mcconkey	C
nancy detert	C
greg abbott	GA
game change	GA
kerry healey	GA
truman boardman	Stub
david cargo	C
michael savage	B
gilbert gude	Start
ernest robinson ackerman	Start
1996 republican national convention	C
scott beason	C
charles swindall	Start
douglas gutwein	Start
bart hester	GA
ruth petroff	Start
manly barton	Stub
abraham lincoln	FA
nettie mckenzie clapp	Stub
sam houston	FA
gil gutknecht	C
clarice navarro	Stub
stewart barlow	Start
charles kostboth	C
derek skees	Stub
shawn hamerlinck	Start
virginia littell	Start
karen karls	Stub
joanell dyrstad	Start
constance horner	Start
brit hume	C
platt adams	Start
beau mccoy	Start
meredith attwell baker	GA
joe crail	Start
polly granzow	Start
warren austin	GA
alan augustine	Start
garrey carruthers	Start
acton institute	GA
gloria vaughn	Stub
charles coughlin	GA
martin hersrud	Start
bill maloney	Start
adam mcmullen	Start
christi craddick	C
first things	GA
tony bouie	Start
joseph rider farrington	Start
michael connell	C
rob standridge	Start
harrison bagwell	GA
jason mumpower	Start
sherry roberts	Stub
kix brooks	C
oliver byerly	Stub
john henry hubbard	Stub
tony core	Start
dwight hawley	Stub
richard treadway	C
john bidwell	C
lonnie laffen	Stub
rich anderson	Start
john davis lodge	C
john nevius	Stub
charlie wolf	Start
oz griebel	Start
kate brophy mcgee	Start
margaret formby	C
chris broadwater	Start
peter percival elder	Start
florida senate majority office	Stub
philip anschutz	B
keli carender	Start
chris cannon	C
john christopher cutler	Stub
the public interest	Start
lee roupas	Start
slander: liberal lies about the american right	C
rob eastlund	Start
kfi	C
ed setzler	Start
thomas forese	Start
david floyd	Start
thomas corwin	C
james tracy hale	Stub
john schnatter	C
sumner lipman	Stub
frank barnett	Start
rich arnold	Start
john tyler hammons	C
franklin wheeler mondell	Stub
portus baxter	C
moses kinkaid	C
farrell dobbs	C
bill lafortune	Start
david agema	C
edith brown clement	C
joshua workman	C
the conscience of a conservative	Start
judy biggert	GA
lee yancey	C
virginia murphy blankenbaker	Stub
james hamilton peabody	C
mark hanna	FA
albert pound	Stub
william murchison	Start
franklin corwin	Stub
bruce fein	B
floyd paxton	Start
edwin flye	Stub
draft condi movement	C
charles neal barney	Start
bryan pedersen	C
alex atwood	Stub
duwayne bridges	Stub
john harris baker	Start
list of critics of the new deal	B
kelly ayotte	GA
philadelph van trump	Stub
marianne brenton	Stub
tom trail	Start
randy rushing	Stub
michael steele	GA
dean cannon	Stub
farmers independence council of america	Stub
phil harriman	Stub
laraine day	C
art schmidt	Stub
susan collins	GA
matt blunt	GA
patricia dillon cafferata	Start
benjamin harvey hill	C
mark kolterman	B
max coll	C
belle haven consultants	Start
james alexander fowler	C
hushang ansary	C
mandate for leadership	C
gene alday	Stub
gary howell	C
william dyke	C
steve buyer	C
john fremont hill	Start
american outlook	Stub
bob skarphol	Stub
kenneth henderson	Start
rich wingo	Stub
marty jackley	Start
douglas forrester	C
franklin macveagh	Start
culture warrior	C
fritz anneke	Start
mainstream republicans of washington	C
janet huckabee	Start
guy edgar campbell	Start
billie orr	C
oakes murphy	Start
josaphat celestin	Start
tim kane	C
chris daggett	C
noble ellington	GA
john rolly ross	Stub
richard howell gleaves	Start
len munsil	C
nolan karras	Start
chris dorworth	Start
jay barker	Start
gary simrill	Stub
ethan orr	Stub
harry gast	Start
zales ecton	Start
ira joy chase	C
blaine luetkemeyer	C
club for growth	GA
ford quint elvidge	Stub
james brady	C
ole amundsen buslett	Start
francis william kellogg	Start
bree van de kamp	B
andrew jarvis	Start
antoine dubuclet	Start
betty de boef	Stub
ron nehring	Start
wyoming republican party	Start
joseph medill patterson	Start
rick jore	C
gianna jessen	C
mark mccullough	C
lane beattie	Stub
glen casada	Start
chip maxwell	Start
thomas hal phillips	Start
hiram barney	Start
liberty fund	C
william hooper councill	Start
jon hinson	Start
mark meckler	GA
chicago school of economics	C
donald steinbeisser	Stub
mike bouchard	C
bill blythe	Start
travis cummings	Start
thomas frank marshall	Start
craig headland	Stub
dan coats	C
alaska republican caucuses, 2008	C
marilyn musgrave	B
joan finney	Start
washington gardner	Start
garet garrett	Start
hiland hall	Start
ken ivory	C
dudley brown	GA
scott angelle	C
mike kopp	GA
the rush limbaugh show	B
herbert urlacher	Stub
ben carson	GA
anne anstine	Stub
peleg emory aldrich	C
augustus hill garland	C
charles nelson pray	Start
bill hansell	Stub
mark moores	Stub
sue ellspermann	C
harrison henry atwood	Start
william hartshorn bonsall	C
william marshall bullitt	C
bob beauprez	C
robert rector	C
gregg harper	Start
wiley drake	C
mark everson	C
nancy rasmussen	Stub
zach howell	Start
richard ziser	Start
stan stephens	Start
steve symms	C
elmer halsey	Stub
mark semlek	Start
taylor brown	Stub
sarah palin interviews with katie couric	GA
electoral history of the american independent and american parties	GA
betsey bayless	Start
eldad cicero camp	B
james weldon johnson	C
william dudley pelley	C
jim gilmore	C
patrick colbeck	Start
charles bailey clarke	Stub
dick ambrose	Start
kelly schmidt	Start
francis fessenden	C
duane sand	Start
herbert titus	C
ellis sandoz	Start
burl cain	C
john judson ames	B
bristol palin	B
leo fraser	Stub
beverly clarno	Stub
mike branch	Start
horace maynard	GA
david josiah brewer	C
thomas mellon evans	Start
george faught	Start
adam hamm	Stub
cindy agidius	C
brad ashford	C
donald grant nutter	C
quico canseco	C
chip huggins	Stub
noal akins	Stub
timothy dukes	Stub
bill hawks	Start
mark darr	C
john dallum	Stub
republican party presidential primaries, 2004	C
mark lowery	Start
roy brun	C
chairman of the new jersey republican state committee	Start
larry deen	C
robert beadles	C
phil nicholas	Start
ranulf compton	Start
jim shockley	Stub
willie dove	Stub
brooks coleman	Stub
sandy greiner	Start
john boyd avis	Start
rickhill	Stub
mike mckevitt	Start
garey bies	Start
claud aspinwall	Stub
victoria toensing	Start
sal iaquinto	Stub
skip rimsza	Stub
thomas haughey	Start
lile gibbons	Stub
bentley rayburn	Stub
john mercer langston	GA
susana martinez	GA
don gosen	C
ward bond	C
independent american party	C
odilia dank	Start
ed lopez	C
pedro del valle	GA
todd gardenhire	Start
john emory andrus	C
william joseph deboe	Stub
james frishe	Stub
gary dahms	Start
kevin mannix	C
rich nugent	C
joseph cao	GA
donny lambeth	Stub
keith regier	Stub
jack riggs	Stub
americans united for life	C
diane anderson	Start
harrison schmitt	GA
stephen sandstrom	Start
mark gilstrap	Stub
schuyler merritt	Start
anna simms banks	Stub
calhoun allen	C
goli ameri	GA
richard stockton field	Start
tom casperson	Start
granville knight	Stub
chuck grassley	GA
tom lubnau	Start
john esp	Stub
mike millican	Stub
kevin brady	C
martin sauer	Stub
republican state committee of pennsylvania	B
coles bashford	C
haley barbour	B
1868 republican national convention	Start
steve gill	C
david kilgore	Start
lewis charles levin	C
matthew gault emery	Start
robert brachtenbach	Start
herman ankeney	Stub
randy borror	Stub
jim ferrell	GA
frederick buhl	Start
william coleman anderson	Start
montana republican party	C
tim begalka	Start
missouri republican party	C
robert haskell	Start
joseph sobran	C
bob jenson	Start
sheila frahm	Start
maryland republican primary, 2008	Start
monroe hayward	Start
susan golding	Start
edward breitung	Start
rebecca jackson	Start
tea peter	GA
albert berkowitz	Start
newt gingrich presidential campaign, 2012	B
dave brandon	C
matt bartle	Start
abe goff	C
kristin mayes	Start
horace fairbanks	Start
ed morrissey	C
albert blakeney	Stub
greg davids	Start
brandon beach	C
republican party presidential primaries	B
dan dorman	Start
stan cooper	Stub
conservative coalition	C
jenna bush hager	GA
steven andersson	Stub
samuel gordon daily	Start
steve eliason	C
william westmoreland	B
brandon creighton	C
jay chevalier	C
lacey davenport	Start
james albert gary	Stub
roger pilon	Start
don lathrop love	Start
freedom partners	C
van hilleary	C
jeff ballabon	C
maryanne trump barry	C
ed bryant	C
matthew rosendale	Stub
invasion: how america still welcomes terrorists, criminals, and other foreign menaces to our shores	Start
marc cherry	C
harris jacob bixler	Start
arthur summerfield	C
jerry paxton	Stub
conservative party of virginia	Start
todd palin	GA
dennis miller	B
marlene anielski	Start
jake flake	Start
republican revolution	C
eunice groark	Start
don coram	Stub
francis burnell	Start
llywelyn breese	Stub
otto wahlrab	C
ken kramer	Start
hillary clinton	FA
richard fale	Start
don barrington	Stub
larry hogan	GA
marshall chrisman	C
nancy spence	C
kim wolfe	Start
lynn gattis	Start
terry calloway	Stub
martha raye	C
mike schulz	Start
milford burriss	Stub
duke aiona	Start
lebaron bradford colt	Start
charmaine yoest	C
cliff asness	C
frank hargrove	Start
maine republican caucuses, 2008	C
bob lalonde	Stub
nandita berry	Start
mark gietzen	GA
mike carrell	Stub
john mccomish	C
jeane kirkpatrick	B
robert daniel	Start
matt rinaldi	C
alex mcmillan	Start
jody amedee	Start
wallace barnes	C
herbert frierson	Stub
republicans for choice	Start
clark burdick	Start
shane jett	Start
matthew hill	C
steve mcmanus	Stub
hiram bingham iii	C
sharron angle	GA
james duane doty	C
michael von flatern	Start
jane corwin	GA
avery bourne	Stub
evan hultman	Stub
mac huddleston	Stub
john marshall butler	C
trammell crow	C
lita indzel cohen	Start
ted daley	Start
smedley butler	FA
chad christensen	Stub
john burger	Stub
russell eddie	Stub
dave hagstrom	Stub
prescott bush	C
russell pearce	GA
joe birkett	Start
edwin feulner	C
irv halter	Start
michele brooks	Start
henry tillinghast sisson	Stub
kevin eltife	Start
thomas clement fletcher	C
hudson institute	GA
robert bacon	Start
frank jimenez	Start
sher valenzuela	C
ulysses samuel guyer	Start
david alexander nunn	Start
james bede	Start
john carona	C
arguing with idiots	C
south park republican	Start
jared weinstein	Stub
carroll gartin	Start
new right	B
sigurd anderson	C
joseph holt	C
lillian feickert	C
carol mcelwee	Stub
lillian gish	C
lurita doan	C
theodore olson	C
dan saddler	Start
gilbert collins	Start
laurie dhue	Start
bill gossage	C
carl curtis	Start
donald bren	GA
cynthia thielen	Stub
stephen bolles	Start
ward hill lamon	C
james mcgrew	Stub
vermont republican party	Start
mike crane	Start
philip becker	Start
jay severin	C
william borah	FA
steve laffey	C
william farrish	Stub
jim colver	Start
jack goodman	Start
brian birdwell	GA
gordon newell mott	Start
teen age republicans	Start
john conness	Start
david marston clough	Start
hiram batchelder	C
bill hembree	Stub
frank antenori	C
barack the barbarian	Start
wesley belter	Stub
terry bradshaw	C
dorothy vest	Start
jared carpenter	Stub
george calhoun crowther	Start
carlos coolidge	Start
bill emerson	Start
jenny horne	Start
rich brauer	Start
roger kane	Start
hans von spakovsky	GA
michelle malkin	C
bill corrigan	C
vernie mcgaha	Start
peter kinder	C
kraig powell	C
matthew quay	C
barbara leonard	Stub
levi johnston	GA
susan lynn	C
theodore christianson	Start
samuel chilton	Start
bart davis	Start
marv diemer	Stub
jon bramnick	C
kirk cox	C
mamie eisenhower	C
steven crowder	C
jeremy durham	GA
lammot du pont ii	Stub
margaret rose henry	Start
robert wynne	FA
bo gritz	C
charlie korsmo	Start
jeff essmann	Stub
jay cooke	C
robert abplanalp	Start
jim buchy	Start
matt mead	C
drew christensen	Start
wayne stahl	Stub
george schuyler	C
wallace mccamant	C
eloy inos	C
keith king	C
pat swindall	Start
ellis yarnal berry	Start
james madison center for free speech	Start
james burrill angell	C
sylvia allen	C
edward devitt	Start
elvin mccary	C
sue wagner	GA
josiah failing	GA
gary cates	Start
scott pruitt	C
republican party presidential primaries, 1980	C
robert blackwill	B
hans hunt	Stub
alexander campbell botkin	Start
paula dobriansky	C
cornerstone policy research	GA
allen alley	C
jim clymer	Start
kit clardy	Start
marty stuart	C
steve buehrer	Start
richard clauselle puryear	Start
dave deyoe	Start
troy andes	Start
ron grooms	Stub
mike nathe	Stub
jeff sessions	GA
katon dawson	C
angie chen button	C
dennis roch	Start
jeremy oden	Start
la verne ausman	Start
bruce burns	Stub
louis monast	Stub
roman hruska	Start
bob anthony	Start
roger macbride	GA
robin beard	Start
ron desantis	GA
katie pavlich	Start
will brooke	Start
glen glass	Start
judson lamoure	Stub
ann coody	C
list of chairpersons of the college republicans	Start
know nothing	B
bill baroni	C
david drovdal	Stub
union reform party of south carolina	Start
chip rogers	C
george despot	C
mike gabbard	C
frank fasi	C
hallie quinn brown	C
edgar warner mann	Stub
richard bond	Stub
dan bilzerian	C
george romney presidential campaign, 1968	GA
war on women	FA
mina hibdon	C
chuck gipp	Start
champ edmunds	Start
paul thurmond	C
wally hickel	C
rhode island republican primary, 2008	Stub
god and man at yale	Start
felix hebert	Start
charles anson bond	Stub
anna crook	C
herman talmadge	C
jim huffman	Start
bob hanner	Stub
republican party presidential primaries, 1960	Start
reed benson	Start
north dakota republican caucuses, 2008	Stub
harri anne smith	Start
david dreier	C
tom hagedorn	Stub
patrick joseph sullivan	Start
greg ballard	C
robert genetski	Stub
clint eastwood at the 2012 republican national convention	GA
charles evans hughes	GA
charles silent	Start
amie beth dickinson	GA
rod grams	C
lyn stuart	Stub
faith and freedom coalition	C
tim armstead	Stub
tom greene	Start
john tippets	Start
lemoine blanchard	C
david cappiello	C
joseph bock	Stub
vol dooley	GA
andrew johnson	FA
john binkley	Start
eurabia	GA
john goedde	Start
mike nemes	Stub
the dartmouth review	FA
seth padelford	Start
bob peeler	Stub
billy guin	GA
edmond spencer blackburn	Stub
morris boyd	Stub
business roundtable	B
william case	Stub
the american catholic quarterly review	Stub
tedd gassman	Start
emery valentine	Start
eugene brock	Stub
denyc boles	Stub
republican conference chairman of the united states house of representatives	Start
frank chodorov	C
scott milne	GA
jim banks	C
frank mockler	Stub
bill hitchens	Start
richard fryman	Stub
john blaisdell corliss	Start
gregg blikre	Start
cliff aldridge	Stub
kelly fajardo	Stub
robert barra	Start
susan brooks	C
kurt saxon	C
conservative mennonites	C
edward bates	C
randy alexander	C
nehemiah abbott	Start
california republican party	B
ryan zinke	C
mark sanford	B
rudy juedeman	B
edward rosewater	C
robert beardslee	Start
joyce ann fitzpatrick	Stub
the weekly standard	C
carol aichele	C
nancy kassebaum	C
taxpayers party of new york	C
malcolm wallop	C
roland arnall	C
ted ferrioli	Start
mike cierpiot	C
paul pacheco	Start
deborah hudson	Start
james kealoha	C
the politically incorrect guide to american history	Start
fulton lewis	C
royal alexander	Start
nebraska republican party	Start
robin armstrong	Start
herbert thomas johnson	GA
oscar lovette	Start
george chanos	Start
benjamin flanders	Start
giovanni capriglione	C
maryanne kusaka	Stub
abijah gilbert	Start
1896 republican national convention	Start
barbara vucanovich	C
nevada republican caucuses, 2008	C
james oscarson	Stub
john william brown	Start
dan kerschen	Stub
ralph samuels	Start
slade blackwell	Stub
american enterprise institute	B
brian bosma	C
rose ferlita	Start
2004 republican national convention protest activity	B
eddie calvo	GA
travis clardy	Start
edwin richley hicklin	Stub
john fremont burnham	Stub
michael roberson	Stub
john schickel	Stub
christian right	FA
evarts worcester farr	Start
wallace jones	Start
king banaian	Start
chris greeley	Start
alonzo baldonado	Start
republicans for immigration reform	Stub
grover cleveland	FA
statewide opinion polling for the republican party presidential primaries, 2008	B
edgar cowan	Start
tim pawlenty presidential campaign, 2012	GA
tennessee ernie ford	C
william clayton anderson	Start
michael duhaime	C
david karnes	C
jonathan chace	Start
craig huey	GA
theodore roosevelt dalton	C
samuel roy mckelvie	Start
james bean	Stub
randy neugebauer	C
owen vincent coffin	Start
tony bucco	Start
art fryslie	Stub
veterans party of america	C
marion gay wofford	Stub
thomas ryum amlie	Start
ford spinks	Stub
james edmund jeffries	Stub
high crimes and misdemeanors: the case against bill clinton	Stub
conservatism in the united states	B
stan monteith	Start
linda lingle	GA
anthony cimini	Stub
guy gabrielson	C
diane black	C
mia costello	Start
shannon erickson	Stub
dan bartlett	Start
richard burdge	Stub
george washington brackenridge	GA
jimmy higdon	GA
owen cleary	Start
lee denney	Start
henry du pont	C
robert agostinelli	GA
dontgo	Start
friedrich hayek	GA
jim bridenstine	C
guam republican caucuses, 2008	Start
glenn richardson	C
john lofton	Start
fred falley	Stub
john frullo	C
david perdue	C
dan maes	C
delus johnson	Stub
james madison leach	Start
lew ayres	C
walter knott	C
jay wolfe	Start
blanche bruce	C
mario civera	Start
matt lindland	C
kevin mcgee	Stub
thyra thomson	C
alan austerman	Start
dean rhoads	Start
judy boyle	Start
oliver wallop, 8th earl of portsmouth	Stub
samuel fenton cary	Start
stewart alsop	C
marge chadderdon	Start
victor ashe	C
harry sandager	Start
linda bean	C
hating america: the new world sport	Stub
ronald black	Stub
sumner baldwin	Stub
john gurley flook	C
ivan lozowy	C
bobby franklin	C
americans for limited government	Start
saxby chambliss	B
william gilliam	Stub
george sokolsky	B
joey durel	C
chris girdler	Stub
joel douglas hubbard	Stub
gary franks	C
willis van devanter	GA
elaine harder	Stub
kathie conway	Start
campbell cavasso	C
robert hilkemann	B
donald dahl	Stub
andrea saul	Start
donald blakey	Start
rod jetton	B
george alfred carlson	Stub
todd gilbert	Start
brian dansel	Stub
jesse helms center	Start
frederick lippitt	C
2012 republican national convention	FA
carl forti	Start
charles mathias	FA
laurie roth	C
eugene atkinson	Start
one dozen candles	Start
penny bacchiochi	Start
ezra pound	FA
clarke reed	GA
luke kenley	Stub
steve corodemus	Start
bob ballinger	C
matt dean	C
tyson larson	Stub
mike conaway	C
deforest richards	Start
david campbell humphreys	Start
carl seel	Start
greg delleney	Stub
elsie arntzen	Stub
calvin coolidge	FA
william albert	Start
mickey gates	Start
tim flakoll	Stub
marilinda garcia	C
theresa lepore	Start
the politically incorrect guide to capitalism	Start
dean clukey	Stub
rick renzi	B
jodi hack	Stub
dick day	C
william medcalf kinsey	Stub
bill ketron	Start
edward hornor coates	C
donald trump presidential campaign, 2016	B
conservativehomeusa	C
lucien barbour	Stub
marilyn brewer	Start
merlin miller	C
lawrence dennis	Start
diane beall templin	Start
ronald reagan presidential campaign, 1980	C
john chandler gurney	Start
beverly gard	Stub
john henry bryant	Start
david asay	Stub
mary bono	GA
robert boal	Start
curt bramble	C
norris brown	Start
ben kieckhefer	Stub
james wickersham	C
michele bachmann	GA
william lemke	Start
kathy campbell	Stub
wes keller	Start
dan kirkbride	Stub
forrester clark	Stub
suzanne crouch	C
frank frantz	C
frank carlson	C
matt caldwell	Start
ralph lawrence carr	C
renee amoore	Start
timothy ray murray	C
john lehman	C
larry pressler	GA
herbert waite	Start
paul akers	Start
roger beyer	Start
melvin clark george	C
mike beatty	Start
jonathan mcniven	Stub
tony burkley	Stub
joseph kenney	Start
sam aaron baker	C
david atwood	Start
richard briggs	Stub
robert list	Start
anna kooiman	C
ken corbet	Stub
john william chapman	Stub
kim brimer	Start
bob corbin	Stub
mama grizzly	GA
sheila bair	C
rod blum	C
thomas frankson	Stub
dan dockstader	Stub
liberty caucus	C
mike cuffe	Stub
wendy nanney	Stub
alabama republican party	C
the vulcans	B
regina bunch	Stub
david decoste	Stub
richard bagger	Start
mike lofgren	C
augustus bove	Stub
randy corman	Start
toby barker	Stub
ron micheli	C
george ashmun	Start
larry brunk	Stub
john sherman cooper	FA
political activities of the koch brothers	GA
iowa republican caucuses, 2000	C
betsy close	Stub
wayne morse	GA
ray canterbury	Start
the politically incorrect guide to english and american literature	Start
jim greer	C
bruce fairchild barton	C
gary pierce	Start
virgil goode presidential campaign, 2012	FA
douglas hodgkin	Stub
treason: liberal treachery from the cold war to the war on terrorism	Start
republican conference of the united states senate	C
volusia error	Start
south dakota republican primary, 2008	Stub
william heilman	Start
charles montague bakewell	Stub
new york republican state committee	C
edward greef	Stub
john rankin gamble	Start
100 people who are screwing up america	B
catherine cloutier	Start
valerie sargent meyers	Start
everett chamberlin benton	Stub
darin mitchell	Start
christopher herrod	Start
merlin hulse	Stub
dustin rowe	Stub
hamilton fish iii	GA
joe stegner	Start
sally kern	C
frank bigelow	Stub
anne northup	C
winfield dunn	C
ed boykin	Stub
william bross	Start
patrick morrisey	C
solon chase	Start
larry border	Stub
raj bhakta	C
republican state committee of delaware	C
charles edward coffin	Start
denny altes	Start
clint didier	Start
irs targeting controversy	B
thomas loertscher	C
david northrup	Stub
ron corbett	Start
ben stein	B
roy moore	GA
carlos cascos	Start
american legislative exchange council	B
don nickles	C
jane dee hull	C
kris kobach	GA
amanda grosserode	Stub
john lamping	C
pete coors	C
antonin scalia	FA
ari fleischer	C
mary forsythe	Stub
beekman winthrop	C
john sirica	C
john cebrowski	Stub
clyde ballard	Stub
lisa benlon	Stub
biff tannen	Start
bill kenney	Start
bernard jackvony	Start
the force of reason	Stub
samuel brenton	Start
jessica gavora	Start
adelbert ames	C
alaskan independence party	GA
james reed hallowell	Stub
christianism	Stub
richard burr	B
samuel myron brainerd	Stub
casey eure	Stub
julius converse	C
andrew card	C
margaret thatcher	FA
the party of death	Start
rick mystrom	Start
ed austin	C
ralph harvey	Start
chuck baldwin presidential campaign, 2008	C
democratic and liberal support for john mccain in 2008	FA
edward tylor miller	Start
michael gambrell	Stub
fred anton	Start
