gayle chaneyfield-jenkins	Start
bennett champ clark	Start
justin woodson	Stub
ken decaria	Stub
charles edmund boyle	Stub
velda jones-potter	Stub
dennis black	Start
art clemente	Stub
frank eugene hook	Start
beth pearce	Start
tomilea allison	Start
frosty boss ribs	Stub
sue crawford	Start
ben kingree	Stub
maryanne jordan	Start
arthur pue gorman	B
buffy wicks	C
anne haskell	Start
ardyce bohlke	Stub
tricia cotham	Start
leonard boswell	C
blanche lincoln	C
barney goltz	Stub
bernice mathews	Start
gunpowder incident	GA
tammy irons	Start
james baumgart	Stub
william arthur bone	Start
lyndon carlson	Start
kite experiment	C
tommy carcetti	C
bill yellowtail	Start
moses macdonald	Start
laurie funderburk	Stub
andrew humphreys	GA
al mcaffrey	C
jake fey	Stub
tom foley	C
david gomberg	C
angel fuentes	Start
william orlando butler	C
samuel beach axtell	C
summers burkhart	Start
rick larsen	C
bill beeny	C
hank weber	Stub
scott meacham	Start
edwin le roy antony	Stub
archibald mcneill	Stub
john montgomery glover	Start
jim justice	C
hollis french	Start
hugh lawson white	B
lillian exum clement	Start
felix robertson	C
bonnie campbell	Stub
danny dahill	Stub
richard bennett carmichael	Start
tim bledsoe	Start
ben allen	Start
geraldine flaharty	Stub
bette lasky	Start
annette cleveland	Stub
segundo llorente	B
terry holley	Stub
betsy hands	Start
patricia lundstrom	Start
union for democratic action	C
ben nighthorse campbell	C
terry deering	Stub
young democrats of north carolina	Start
list of federal judges appointed by andrew jackson	B
mary hooper	Stub
robert mccoy	Stub
green party of the united states	GA
horace boies	Start
dale mccormick	Start
bloody bloody andrew jackson	C
jo oldson	Start
bob buch	Stub
karen clark	Start
scott mcadams	C
albert ghiorso	C
andrew falk	Start
cleta mitchell	C
mary hales	Stub
chris steineger	Start
joseph danielsen	Start
barnabas burns	Start
martin jenkins crawford	Start
leo foley	Start
jared brossett	Start
al eisenberg	Start
ken burns	B
clement claiborne clay	C
augustus high	Stub
william waters boyce	Stub
victor bussie	GA
pat waak	C
walk in my soul	Stub
joseph taylor robinson	GA
jesse jackson presidential campaign, 1984	Start
thomas kilby	Start
stephanie kwolek	GA
gilmer capps	Stub
john moran bailey	Start
daniel poling	Start
isabella greenway	C
terry canales	Start
steve bieda	Stub
dave cortese	Start
warren worth bailey	Start
bill bowles	Stub
dennis arakaki	Stub
george abert	Start
rachel binah	Stub
daniel kagan	C
fred deering	Stub
john mizuno	Stub
steve lukert	Stub
tony coelho	C
byron baer	C
william baldwin	C
arvonne fraser	Start
lori millin	Stub
franklin quitugua	C
james israel standifer	C
1832 state of the union address	Stub
david dill	Start
edward casso	C
indiana democratic primary, 2008	GA
clara burnett	Stub
oliver winfield killam	C
joe reardon	Start
akpd message and media	Start
neil abercrombie	C
muriel humphrey brown	Start
stephen casey	Stub
leonardo dicaprio	GA
jon hulburd	GA
cheryl lynn allen	Start
matt cartwright	C
karen awana	Start
james monroe	B
ping duenas	C
lia marie johnson	C
lucius quintus cincinnatus lamar ii	C
gatewood galbraith	C
maude findlay	C
norman zabusky	Start
david fraser-hidalgo	Start
weldon nathaniel edwards	Start
karen macbeth	Start
kenneth lamar holland	Start
robert moak	Stub
mary jane wallner	Stub
cook county democratic party	B
jonah kumalae	C
stephen higgins	Stub
andrew jackson hamilton	C
franklin freeman	Stub
democratic caucus chairman of the united states house of representatives	B
brian bushweller	Start
brownie ledbetter	C
corey palumbo	Stub
nicholas sickles	Start
donna soucy	Stub
bazy tankersley	FA
isaac choy	Start
johnny dupree	C
jimmy leawood martin	Stub
philip baruth	C
ken helm	Stub
jackson purchase	C
grailey berryhill	Start
abraham ellison garrett	Start
will espero	C
tulip grove	Start
stewart udall	C
democratic legislative campaign committee	Start
richard thurmond chatham	Start
1984 democratic national convention	Start
paul van dam	Stub
vicki been	Start
2014 las vegas shootings	GA
mary jo kopechne	GA
bob andrzejczak	Start
beverly daggett	Start
charles fletcher johnson	Start
christine canavan	C
victor cushwa	Start
tom adelson	C
spark matsunaga	C
ryan fecteau	Start
jonathan earle arnold	Stub
michael woolston ash	Stub
herman goldner	GA
floyd esquibel	Start
josephine roche	C
matt groening	GA
richard erwin	Start
grace berg schaible	Start
john isaac guion	Start
joseph cable	Start
washington bartlett	Start
francis thomas	C
rosalynn carter	FA
eduard rivera correa	Stub
nancy nathanson	Start
bill clinton	GA
kenneth maryboy	B
carla cunningham	Stub
ian calderon	Start
james david santini	Start
edward zorinsky	C
david sokola	Start
bernice layne brown	Stub
franklin brockson	Start
carla piluso	Stub
ruthann aron	C
tom bergeron	C
albert dekker	C
sheila kiscaden	Stub
thomas burton hanly	Stub
clay aiken	GA
irene bustamante adams	Start
carl hines	Stub
frederick van voorhies holman	GA
michigan five fluke freshmen	Start
tom carper	C
susan allen	Start
john moonan fitzgerald	Stub
ben chandler	C
starling tucker	Stub
marvin minsky	C
john verkamp	C
thomas crowley	Stub
john alcala	Stub
joseph braig	Stub
patti fritz	Start
jesse laslovich	Start
joann ginal	Start
robert williams daniel	GA
pat spearman	Start
william baylies	Start
barbara ackermann	Stub
allan benny	Stub
light a distant fire	Stub
arthur broadhurst	Stub
paul carmouche	C
mary easley	Start
greg leding	C
thomas colapietro	Stub
franklin garcia	Stub
jeannette bell	Stub
henry kalis	Start
idaho democratic caucuses, 2008	C
daniel da ponte	C
leslie combs	Stub
mike blouin	Start
william van ness bay	Stub
matt entenza	C
world policy journal	Start
drauzin angelle	Start
benjamin franklin house	C
peter franchot	C
alexander cheves haskell	Start
ako abdul-samad	Start
bremer ehrler	Stub
allen derr	Start
gaynor cawley	Start
daniel newnan	Start
aaron burr	FA
russell blair	Stub
robert bullock	Start
william emerson brock	Start
andrew jackson centre	Start
buddy caldwell	GA
debbie hammons	Stub
florida democratic primary, 2008	C
bob conley	C
william haile	Start
randall friese	Start
democratic party of virginia	GA
shien biau woo	C
marcie maxwell	Stub
jim hood	C
davy crockett	C
david emmons johnston	Start
mamye bacote	Start
aneesh chopra	C
hugh buchanan	Start
william hartman	Start
buie seawell	Start
don chafin	GA
judy clibborn	Stub
jim kastama	Start
bill boner	C
joseph clay stiles blackburn	Start
betty roberts	GA
albert burstein	Start
ron calderon	C
pea ridge national military park	C
massachusetts liberal	Start
list of barack obama presidential campaign endorsements from state, local and territory officials, 2008	B
joseph abruzzo	GA
tommy gollott	Stub
waldemar rivera torres	Stub
ben frasier	C
george washington	GA
claude-anne lopez	C
humphrey bogart	GA
frank gorrell	Start
drayton boucher	C
michael bakalis	Start
albert boscov	Start
sandy berger	C
julio brady	C
gary lebeau	C
robert angers	C
strobe talbott	C
scott dianda	Stub
ann marie doory	C
gerard luz james	C
jim omerberg	Stub
james french patton	Start
obadiah gardner	Start
zvi hashin	Stub
thomas bell monroe	Start
william diamond	Start
silas wright	C
marti crow	Start
nilsa cruz-perez	C
george kinley	Stub
matthew deady	FA
nancy boyda	C
harry gandy	Start
edward mezvinsky	C
christine scanlan	C
james farrington	Start
alexander hamilton coffroth	Start
charlie dooley	Start
frances farenthold	C
andrew dewitt bruyn	Start
sam blackwell	Stub
donn charnley	Stub
claude bowers	C
texas democratic primary and caucuses, 2008	C
edward braunstein	Stub
kay halloran	Stub
west virginia democratic party	C
william coblentz	C
marie donigan	Start
george washington covington	Start
phil cavanagh	Stub
timothy massad	GA
jerry northington	Start
william dunbar holder	Stub
rosalind kurita	Start
dante fascell	Start
united states presidential election in illinois, 2008	GA
benton jay hall	Start
patricia serpa	Start
results of the 2008 democratic party presidential primaries	B
samuel bryan	Stub
melissa bean	C
lincoln chafee	GA
kc becker	Stub
severin beliveau	Start
nevada democratic caucuses, 2004	Stub
george brunjes	Stub
ted schwinden	Start
andrea doll	Stub
alice louise reynolds	C
john mclean	C
james coffield mitchell	Start
multinational monitor	Start
john cessna	Start
joseph bouck	Start
bethany hall-long	Start
landon carter haynes	B
william daniel johnson	GA
bob beckel	GA
james wilson	C
ron cease	Stub
list of latino democrats	C
rhode island democratic primary, 2008	C
katherine hanley	C
jabez willes	Stub
mike massie	Stub
henry hollis horton	C
lucianne goldberg	GA
tennessee democratic party	C
james moore wayne	GA
clair armstrong callan	Start
sherrod brown	FA
howard shultz miller	Start
alvin bronson	Start
adam edelen	C
latanya garrett	Start
robert broadnax glenn	Start
memphis to little rock road-village creek segment	Stub
mendel jackson davis	Start
johannah leddy donovan	Stub
corrine brown	B
ed schultz	B
ed ableser	Stub
frank logue	Start
elwood thorpe	Stub
donald abraham	Stub
united states presidential election, 1824	FA
steven beckwith ayres	Start
clifton daniel	Start
alternate presidents	B
janie ward-engelking	Start
hiram parks bell	Start
david carlin	Stub
noadiah johnson	Stub
chris spirou	Stub
rachel jackson	C
lydia blume	Stub
reuben chapman	Stub
left coast	Start
ronnie musgrove	C
michael marcello	Start
asahel bush	C
mark eves	C
mike mansfield	C
1944 democratic national convention	C
charles calderon	Start
democratic freedom caucus	C
bob dearing	Stub
john kerry	B
maine democratic caucuses, 2008	Start
billy joe camp	Stub
austin badon	C
liz carpenter	C
heather french henry	Start
brendan boyle	GA
benjamin stark	C
finley hamilton	Stub
william franklin	C
bernadine craft	Stub
michael joseph gill	Stub
mordecai manuel noah	C
joseph chinn	Stub
budd bb-1 pioneer	C
chip forrester	Stub
patrick bourne	Stub
mike lawlor	C
speckled snake	Start
coleman livingston blease	C
jeff hayden	Start
montgomery blair	C
eliot glassheim	Stub
charles gustav binderup	Start
robert monell	Start
curt hanson	Stub
los angeles county young democrats	Start
joseph biles anthony	Stub
raj goyle	C
nancy ammerman	Start
frank ellsworth doremus	C
bill kiskaddon	Stub
faye hanohano	Start
kenton onstad	Start
united states declaration of independence	FA
gideon lee	Stub
draft mark warner movement	Start
john hodgdon	Stub
benjamin bosse	Start
district of columbia democratic state committee	Start
john martinis	Stub
emily newell blair	B
martin frost	C
mace moulton	Start
boyd cypert	B
roy carl carlson	Stub
william marcellus howard	Start
heath mello	C
william beavers	C
dennis mckinney	Start
frank steunenberg	C
david guttenberg	Stub
maggie williams	C
edward keating	C
bill cleveland	C
benjamin antin	Start
robert crosser	Start
funk heritage center	Stub
john eugene osborne	Start
pierce mason butler	Start
lynde bradley uihlein	Start
bill wielechowski	C
duncan stephen walker	Stub
luther campbell	C
satveer chaudhary	B
balie peyton	Start
walt minnick	C
the new republic	B
democratic party presidential primaries, 2016	GA
markos moulitsas	C
bill cahir	C
anita alvarez	C
joey manahan	Start
ron klain	C
elisha haley	Start
robby mook	C
william leighton carss	Start
ezequiel cabeza de baca	Start
david bulova	Stub
tom vilsack presidential campaign, 2008	GA
karen freeman-wilson	C
barack obama assassination plot in tennessee	FA
jeb bardon	Stub
william sprague iii	Start
david douglas wagener	Stub
dede feldman	Stub
frederick condit	Start
geoffrey fieger	C
daniel dunklin	GA
linn banks	Start
jim riesberg	Start
carolyn pease-lopez	Stub
henry cousins chambers	Stub
benjamin markley boyer	Stub
curtis hooks brogden	C
samuel price	Start
david cone	B
chris giunchigliani	Start
phillip brutus	Start
nicholas spaeth	Start
barbara-rose collins	Start
new democrat network	Start
paul dillingham	Start
leslie osterman	GA
albert sidney camp	Start
edward sandoval	C
john jarman	Start
michael william brescia	Start
franklin prophecy	C
john engen	Stub
tim miley	Start
bill aswad	Start
donna edwards	C
richard carsner	Stub
demzilla	Stub
walter flowers	Start
patsy mink	C
tina kotek	Start
ross boggs	Stub
gail chasey	C
stephen kafoury	Stub
rowland day	Start
abel huntington	Stub
barbara boyd	Start
joseph patrick addabbo	Start
grady brown	Stub
james kerzman	Stub
charles tyroler ii	Stub
walt brown	C
sylvia luke	Start
dannel malloy	GA
stephen buhrer	Start
lyle koenen	Start
iris kyle	GA
grace adler	C
buford ellington	B
john businger	Stub
arthur sewall	Start
homer heck	Stub
rocky fitzsimmons	Stub
sally fox	Stub
ronnie earle	C
bob hunskor	Stub
steven geller	Start
michelle stennett	Start
johnston cornish	Start
hob bryan	Stub
george williams cassidy	Start
oden bowie	C
1964 democratic national convention	C
juan carlos escamilla	Stub
geran tarr	Stub
billy chandler	C
moses bloom	C
gideon welles	C
darwin thomas	Stub
ikaika anderson	Start
henry bruckner	Start
thomas samuel ashe	Start
arn menconi	Start
oscar braynon	Start
dixie gilmer	Start
william temple franklin	B
richard alarcon	Start
earl pomeroy	C
paul bardacke	Start
steve warnstadt	Start
robert mac	Start
aaron krauter	Stub
mary broadaway	Stub
jane briggs hart	C
democratic party presidential primaries, 1980	GA
lois court	C
jamie fox	Start
jim webb presidential campaign, 2016	GA
john lewis brenner	Start
marco mcmillian	Start
andrew coulouris	Start
carter barron	Start
nicole collier	Start
stan frownfelter	Stub
1960 democratic national convention	C
campaign rhetoric of barack obama	C
marshall formby	GA
cynthia nava	Stub
new york democratic primary, 2004	Stub
janet cowell	C
marion butler	C
don bonker	Start
art agnos	C
walter chandler	Start
ebenezer mack	Start
scott baltz	Stub
aryan republican army	Start
francis xavier mancuso	Stub
beth finch	Start
richard carmona	C
gerald calabrese	Start
seaton grantland	Stub
ray aguilera	Start
george goldthwaite	Stub
miguel del valle	C
james cagney	FA
vicki englund	Stub
league for independent political action	GA
john logan chipman	Start
michael moore	GA
valencia seay	Stub
innis green	Stub
sheldon johnson	Start
serena southerlyn	GA
hillary 1984	Stub
martin heinrich	C
john patrick carney	C
clay tallman	Stub
mark hashem	Start
andrew jackson bryant	C
clark hamilton	Stub
myrna loy	GA
ben mcadams	C
william estabrook chancellor	C
william fadjo cravens	Start
charlene lima	Stub
bruce whitehead	Start
robert byington mitchell	C
jeff boss	Start
hank hancock	Stub
charles halsted	Start
carrie austin	Stub
walter felag	Start
brian schweitzer	B
joseph salazar	Stub
saundra meyer	Stub
ian bowles	C
judith won pat	C
pete campos	Stub
wilson godfrey harvey	Start
kate ebli	Start
marko liias	C
ferdinand mercado	Stub
katie edwards	Start
don perdue	Start
cathy harvin	Stub
nicholas mattiello	Stub
international media reaction to the united states presidential election, 2008	FA
walt helmick	Start
nancy dinardo	Stub
james philip eagle	Start
david rice atchison	GA
wendell abraham anderson	Start
jake butcher	Start
hugh nibley	GA
robert ellis cahill	Start
mitch greenlick	Start
sarah yorke jackson	Start
pete lee	C
lisa poppaw	C
zach galifianakis	B
joseph hammons	Start
elbert gill	Stub
john boccieri	Start
john truman stoddert	Stub
billy adams	Start
puerto rico young democrats	Start
mary mascher	Stub
richard seymour rodney	Start
mark maryboy	B
joe hendricks	Start
katrina swett	C
1872 democratic national convention	Start
andria bennett	Stub
denise dittrich	Start
parris glendening	C
bryan kaenrath	Stub
john milton glover	Stub
joseph corpora	Stub
helen klanderud	GA
bruce hugo	Stub
koryne kaneski horbal	Start
shirley breeden	Stub
al from	C
les bock	Start
tommy burks	Start
herbert deskins	Stub
lloyd mccuiston	Stub
john hessin clarke	C
john creswell	C
marcus gaspard	Stub
tom allen	Start
winfred dukes	Start
charles rollin keyes	Start
karen morgan	Stub
julian hartridge	Start
darlene hooley	C
severo colberg toro	Start
delis castillo rivera de santiago	Stub
william banach	Stub
ed harbison	Stub
diane mitsch bush	Stub
belle kearney	Start
jason lorber	Start
barack obama presidential eligibility litigation	GA
dana lynch	Stub
tracy beckman	Start
howard berman	GA
benjamin travis laney	Start
charlie hales	C
alonzo dillard folger	Start
daniel lundby	Start
maria contreras-sweet	C
morgan cassius fitzpatrick	Start
john bidwell	C
larry larocco	C
stephen benedict grummond	Start
carl trujillo	Stub
gordon kahl	C
levi beardsley	Start
stephen easley	Stub
suzanne bergansky	Stub
lewis samuel partridge	C
matt dunne	C
democratic party presidential primaries, 1956	Start
john burkhalter	Start
edward burnett	Start
melany barnes	Stub
laura boyd	Start
henry aquino	Start
john wilson campbell	Start
marc dann	C
enos lowe	C
pete rouse	C
kate marshall	C
sampson willis harris	Start
ernest gruening	C
asa fowler	Start
william cooley	FA
merle lansden	Start
william evans arthur	C
robert bunda	Stub
robert francis withers allston	Start
ben unger	Start
toney anaya	C
dennis keene	C
tonya anderson	Stub
adino nye bell	Stub
rae waters	Stub
cheryl glenn	Start
jay carson	C
margaret hurley	Stub
dick cohen	C
jim clyburn	B
utah stonewall democrats	C
michael mccaffrey	C
frank chelf	Start
hazel erby	Start
alcee hastings	C
rosalyn dance	C
barbara lampert	Stub
democratic party vice presidential candidate selection, 2008	GA
calvin sutker	Stub
thomas gaffey	C
judy gold	C
waco, the big lie	Start
john morrissey	C
todd compton	C
spencer hawley	Start
united states twenty-dollar bill	GA
democratic party presidential primaries, 1996	Start
mitchell cary alford	C
jerry meek	Start
minnesota democratic caucuses, 2008	C
robert worth bingham	C
bruce ennis	C
lloyd barbee	Stub
junius marion futrell	Start
marvin griffin	C
kylie oversen	C
brian ashe	Stub
democratic congressional campaign committee	GA
steven horsford	C
earl hogan	Start
harold patten	Start
paul lauterbur	GA
jon bauman	Start
thomas buchecker cooper	Stub
democrats for nixon	Start
blackfish lake ferry site	Stub
deb miller	Start
matthew butler	C
betty nuovo	Stub
mary elliott flanery	C
jim brewster	Stub
norman conway	C
carol berman	C
donald betts	Start
ronnie ansley	Stub
henry saavedra	Stub
moderate dems working group	Start
oz bengur	Start
gordon browning	GA
mindy greiling	Start
dean johnson	C
george john kindel	Stub
joe stell	Stub
frederick berry	Stub
robert abrams	C
adam garfinkle	Start
thomas walter bickett	Start
david plouffe	C
eric samuelsen	C
dennis canario	Stub
barbara burns	Stub
glenn wakai	C
key pittman	C
buffie mcfadyen	Stub
richie robb	Start
raymond garramone	Stub
abijah beckwith	Stub
neria douglass	Start
chris abele	C
andrew butler	C
clyde kersey	Stub
hill harper	C
rosemary decamp	C
karen shepherd	C
jere hargrove	Start
michael anthony bilandic	C
orlando luis garcia	Start
debra bowen	C
marty block	Start
experiments and observations on electricity	C
todd hollenbach	Start
mahlon dickerson	Start
mary mcnally	Stub
popular democratic party of puerto rico primaries, 2012	C
john rinehart blue	C
robert johnson iii	Stub
evie hudak	C
rory reid	C
john parker boyd	C
sam arora	C
thomas paine	B
james doyle ii	Stub
william augustus ayres	Start
eric griego	Stub
regina h bartholomew	Stub
joan menard	Start
ben bagert	C
young america movement	C
david mckee hall	Start
john blatnik	Start
eli jones henkle	Start
tom hayhurst	C
lawrence becker	Start
charles alexander harvin	Stub
josian santiago	C
andrew jackson caldwell	Start
deandra reynolds	C
steve beshear	FA
carol juneau	Stub
john alexander cocke	C
romulus mitchell saunders	Start
fred duval	C
democratic caucus of the united states senate	Start
kathy greenlee	Start
james handlan	Stub
gerald curran	Stub
soren simonsen	B
thomas hackney	Stub
will bailey	C
carol bellamy	C
edward crossland	Start
denver dickerson	C
charlotte burks	Start
sheila dixon	GA
roy lacey	Start
barbara buono	C
ben affleck	FA
samuel baptiste	Start
eduardo ferrer	Start
angela coleman	Start
chuck middleton	Stub
thomas mitchell campbell	Start
ibra charles blackwood	Start
zach braff	C
james curtiss	C
ed trimmer	Stub
johnny tadlock	Stub
virginia democratic primary, 2004	Start
michael albano	Start
ken haar	C
christopher rankin	Start
kelly mccarthy	Stub
billie jean floyd	C
wallis annenberg	C
sandra fluke	GA
benjamin franklin national memorial	Start
democratic party presidential primaries, 1984	C
sidney johnston catts	Start
george distel	Stub
myndert van schaick	Start
joseph mann	Start
joan kroc	C
rosa franklin	Stub
anne cox chambers	C
richard houston dudley	Start
carl albert	C
wilkinson call	Start
jerry kearns	Start
eugene laughlin	Stub
bobby crim	Start
ethan kanin	Start
john randall reding	Stub
lisa marrache	Stub
luther martin	B
joe frank harris	Start
james armes	C
rafael fraguela	Start
david haley	Start
voit gilmore	Stub
indiana democratic party	C
godfrey hounsfield	C
joseph draper	Stub
william haselden ellerbe	Stub
demas barnes	Start
brad ellsworth	C
david mcbride	C
joni jenkins	Start
joshua svaty	Start
debbie cook	C
jason frierson	Start
may arkwright	Start
william shepperd ashe	Start
susan paddack	Start
david wanzenried	Stub
democratic leadership council	C
derrick pitts	Stub
moses thatcher	Start
mike runnels	Stub
james bilbray	Start
terry gerratana	Stub
donna moss	C
pascal ballade	C
cylvia hayes	GA
thomas hill williams	Stub
phillip edward chappell	Stub
kelly cassidy	Start
ralph archbold	Start
james beach	C
walter dee huddleston	Start
dennis egan	GA
bidwell adam	GA
jim roth	Start
philemon dickerson	Start
rob briley	C
jaime fuster	Start
george kupka	Stub
frank ferri	Start
charles slade	Stub
brent barton	Start
101 people who are really screwing america	GA
bill amerman	Stub
andy fleischmann	Start
lowdon heller	Stub
unto these hills	Start
alan casavant	Stub
doug bovin	Start
cy bahakel	Start
david ige	C
jane cease	Stub
glenn freeman	Stub
mckamie farmhouse	Stub
fred biermann	C
sanford alexander moss	Start
carolyn squires	Start
james casorio	Stub
dominick moreno	Start
harden bennion	Start
clark clifford	C
luke clippinger	C
michael john gray	Start
javier gonzales	C
tony exum	Start
frank cownie	Start
chet blaylock	Start
john pinto	Stub
trish weedn	C
dan feltes	Stub
horace ladd moore	Start
patricia hymanson	Stub
merle tuve	C
karl dean	C
john quincy adams ii	C
john arthur eaves	C
adam wool	Stub
martin behrman	Start
cora brown	Start
samuel blake	Stub
betsy butler	Start
second inauguration of andrew jackson	Stub
charles barwig	Stub
larry butts	Stub
adam brown littlepage	Start
goodloe byron	Start
nathaniel garrow	Stub
frank blackburn	Start
florian chmielewski	Stub
south dakota democratic primary, 2008	Start
sanford bishop	C
lorraine bracco	C
john kitzhaber	GA
chuck hoskin	Start
joseph battisto	Start
jen seelig	Start
james iver mckay	Start
uriel sebree hall	Start
democratic and liberal support for john mccain in 2008	FA
jim ferraro	C
jack markell	C
earl garrison	Stub
janice fisher	Start
david sigdestad	Stub
joe satrom	Start
james collier	Start
charles hoodenpyl	Stub
charles laban abernethy	Start
reuben whallon	Stub
caroline killeen	Start
sam boaz	Stub
benjamin alden bidlack	Start
david curson	Start
william cannon	C
laird howard barber	Start
paulette jordan	C
ted kennedy	FA
nellie gorbea	C
constance triplett	Stub
pierre bossier	Start
serranus clinton hastings	GA
samuel locke sawyer	Stub
carte goodwin	GA
emily donelson	C
john flerlage	Start
james thomas heflin	C
carolyn coleman	Start
willard preble hall	Start
ray mabus	C
david friedland	B
agostinho silva	Stub
john jay hooker	C
samuel birdsall	Start
samuel cushman	Start
carol ammons	Start
floyd allen	B
sextus barbour	C
vera buchanan	Stub
george mcduffie	Start
george till	Stub
armando franco	Stub
nathaniel exum	Stub
russ karpisek	C
james earickson	Stub
oliver ernesto branch	C
jewel lansing	Start
chuck dow	Stub
dan donahue	Stub
waco: the rules of engagement	Start
john richard barret	Start
clarence dill	C
chris dodd	GA
sean burrage	Start
richard henry clarke	Start
theresa lepore	Start
eileen cody	Stub
don gaffney	Stub
joe wineke	Start
jeromus johnson	Stub
joel heitkamp	Stub
democratic party presidential primaries, 1976	C
jerome cosentino	Start
donald culliver	C
colin van ostern	C
clarence royce	C
richard fulton	C
leah landrum taylor	Stub
sharon erickson ropes	Start
fred belardi	Stub
edwin augustus keeble	Start
jim mattos	Stub
carlyle begay	Start
clay davis	C
jesse speight	Start
chris biggs	C
matthew bradford	Stub
alexis davis	C
sterling foster black	Stub
doug racine	Start
bob clement	C
hanover tavern	Start
andy josephson	Stub
north carolina democratic party	C
patrick caddell	C
susan bysiewicz	C
arlo hullinger	Stub
jill derby	C
kevin blaum	Start
frank chopp	C
noble jones gregory	Stub
ether shepley	Start
andy coats	Stub
joan cadden	Start
norm dicks	C
brian patrick kennedy	C
peter zack geer	Start
brad carson	GA
julianna smoot	Start
woodbridge nathan ferris	Start
rhea chiles	C
jim dunnam	Start
blue spring heritage center	Start
grattan kerans	C
joe erwin	Start
hiram sanford stevens	GA
john kerry presidential campaign, 2004	B
james dixon	Start
annette bening	C
rosalind mcgee	Stub
benjamin dean	Start
john mills houston	B
sands gayle	Stub
daniel ivey-soto	Stub
american enlightenment	B
statewide opinion polling for the democratic party presidential primaries, 2008	B
jeff jacobs	Stub
daniel hunt gilman	C
missouri democratic primary, 2004	Start
jerry costello	Start
william laird iv	Start
nancy virtue lewis	Start
gilda cobb-hunter	Stub
scott kleeb	C
joyce woodhouse	Stub
augustine clarke	C
julie bunn	Start
steve cohen	GA
rodger randle	Start
lamar looney	C
jake metcalfe	Start
nathaniel boyden	Start
samuel jordan cabell	Start
peter kyros	Start
loranne ausley	Start
art kirkendoll	Stub
ross miller	C
lucius jeremiah gartrell	Start
ralph carey geer	C
kelly alexander	Start
charles merian cooper	Stub
hubert humphrey presidential campaign, 1968	FA
maude frazier	Start
virginia mae brown	C
gaston caperton	C
kent caperton	C
george plumer	Stub
raymond buckley	C
hillman terome frazier	Stub
myrtle cole	Stub
birch bayh	GA
judy dodge	Stub
mayhew folger	Start
martin sennet conner	Start
thomas henry ball	Start
bill alcorn	Stub
tyrone brooks	Stub
louis freeh	B
sydney carlin	Start
nathan belcher	Stub
brian schatz	C
ryan ferns	Stub
james arciero	Stub
ron fragale	Stub
sal albanese	C
howard costigan	B
vito albanese	Start
james moyle	C
denver butler	Start
lon burnam	Start
hannibal hamlin	C
sharon pratt kelly	C
joshua boschee	Stub
franklin stove	C
martha layne collins	FA
dennis moore	C
lesley cohen	Stub
harold copenhaver	Start
carter glass	C
jim lindsey	Start
don calloway	Start
jim francisco	Stub
arthur corvese	Start
theodore arlington bell	Stub
north dakota democratic caucuses, 2008	C
molly kelly	Stub
janet reno	GA
barbara granlund	Stub
henry nes	Start
adam fetterman	Start
max gruenberg	Stub
ralph acosta	Stub
george henry clinton	Start
ilana rubel	Stub
antonio borja won pat	C
david jacoby	Start
samuel cony	Start
democrat in name only	Stub
rosa delauro	C
1880 democratic national convention	FA
mae flexer	Stub
beverly bustin	Start
mark ciavarella	C
frank licht	C
gery chico	C
jon hinck	GA
charles le moyne mitchell	Stub
stamp act congress	GA
aldamar elder	Stub
joan growe	Start
ignacio de la fuente	C
tom currigan	Stub
emily couric	Stub
clay crupper	Stub
george latham fletcher	Stub
edward fenwick tattnall	Stub
jim himes	C
skdknickerbocker	C
arnold williams	Stub
doris johnson	Stub
perry owens	C
kinky friedman	GA
robert cooper grier	C
joseph montoya	Start
wanda grinde	Stub
gustavus miller bower	Stub
henry bethard	GA
beau biden	GA
sally ann gonzales	Start
franklin bartlett	Start
trail of tears	B
william barksdale	C
jay disharoon	Stub
dan boren	C
annie tietze	Stub
george edward mitchell	Start
barack obama assassination plot in denver	GA
tackey chan	Stub
crisanta duran	Start
hair conrad cabin	Start
bruce morrison	C
stanford morse	GA
mary ann handley	Start
catherine miranda	Start
mary meyer gilmore	Stub
al ater	C
james allred	C
rod driver	C
aedanus burke	Start
mike turpen	Start
samuel cutler ward	C
martin looney	Start
david caprio	Start
joseph bouchard	C
new mexico democratic primary, 2008	Start
eugene casserly	Start
cordell hull	C
janet napolitano	GA
democratic party of wisconsin	C
jimmy carter	B
william bennett	C
edith green	C
samuel azzinaro	Start
richard lamm	C
ted koffman	Stub
rebecca blank	C
marko dapcevich	C
mike boyle	Start
billie sutton	Start
muriel bowser	C
kenneth cox	Start
chester dunning	Start
john jenrette	Start
homer bone	Start
john van lear findlay	Start
william forsee	Stub
iowa democratic caucuses, 2000	Start
rafael cordero santiago	C
robert woodward barnwell	Start
norman jay coleman	Start
valerie wiener	Stub
nathan ballard	C
james broadhead	Start
tom hancock	Stub
choctaw trail of tears	C
selucius garfielde	GA
missouri democratic primary, 2008	C
asbury bascom davidson	Stub
chuck caputo	Start
nell scott	Start
richard grant augustus donnelly	Stub
kathryn sessions	Stub
mike huckleberry	Start
jeptha wade	C
diana dizoglio	C
william voris gregory	Start
pramila jayapal	C
william dougherty	C
william branch giles	C
cindy chavez	Start
delazon smith	Start
opinion polling for the democratic party presidential primaries, 2004	Start
gary branae	Stub
max cleland	C
laruby may	GA
carol browner	FA
eric holder	FA
jason chaffetz	GA
patricia roybal caballero	Start
stephen colbert	GA
william carris	Stub
maryon pittman allen	C
pamela beidle	Start
rufus mcintire	Start
denise merrill	Start
jacob crocheron	Stub
tulsi gabbard	C
carlos delgado altieri	Stub
barack obama	GA
neal foster	Stub
manuel natal albelo	GA
ed mayne	Start
carl andrews	Start
dick sedar	Stub
thompson campbell	Start
al ullman	C
richard mentor johnson	FA
ramsey clark	B
sam gibbons	C
bruce ayers	C
dan kelley	Start
alexander farrelly	Start
john connally	C
bill john baker	C
linda hamilton	GA
presidential transition of barack obama	FA
homer martin adkins	Start
ross barnett	GA
john warren cooke	Start
preston brooks	C
thomas bothwell jeter	Start
barack obama presidential campaign, 2012	GA
tom huntley	Start
david koresh	C
tom bakk	C
alfred metcalf jackson	Start
craig fitzhugh	C
larry lucas	Stub
bernie sanders presidential campaign, 2016	FA
jeffery donohue	Start
mike michaud	C
william grannell	Stub
warren braun	Stub
fort barrancas	GA
wendell byrd	Stub
gabriel moore	Start
bob cashell	Start
william macvane	C
lataisha jackson	Stub
claiborne pell	B
devin beliveau	Start
gary christenson	Start
jay inslee	B
wendell anderson	Start
gentry crowell	Start
herbert covington bonner	Start
louise bishop	Stub
denise juneau	C
edward white patterson	Stub
preston callison	C
hardin cox	Stub
james marshall head	Stub
frank kassela	C
adele khoury graham	Start
robert mehlhoff	Stub
nathan philemon bryan	Start
steve cappiello	Start
joan carter conway	C
william cox ellis	Stub
toby morris	Start
kyrsten sinema	GA
thomas theodore crittenden	C
jean breaux	Stub
jack billion	Start
mike easley	B
north dakota democratic caucuses, 2004	Stub
wyatt aiken	Start
jim herring	Start
anthony foxx	C
thomas mcelveen	Stub
dawn hill	Stub
kim henry	C
john breckinridge castleman	Start
john davoren	Stub
lee metcalf	GA
austin lane crothers	Start
the autobiography of benjamin franklin	C
jessie danielson	C
jane hadley barkley	Start
mark funkhouser	C
solon borland	C
jasper brancato	Stub
john judge	Stub
geoff garin	Start
steven ediger	Stub
1968 democratic national convention	GA
betty adkins	Stub
lindley beckworth	Start
gabriel bouck	C
julius ansel	Stub
sara kyle	Start
william augustus hall	Start
rick metsger	C
dale grubb	Start
ann mclane kuster	C
edward coke crow	Start
jerry sandel	Stub
edward osienski	Start
john catlett	Start
doug berger	C
john milton elliott	Start
lewis beach	Start
albany plan	Start
mark ferrandino	C
roy bass	C
joe aull	Start
john caskie	Start
henry william connor	Start
jim jacks	Stub
julian bond	GA
anna belle wiedemann	Start
lea whitford	Stub
alfred flores	C
susan longley	Start
lisa fobbe	Start
dismas becker	Start
genevieve blatt	C
tim briggs	Start
mitch tropila	Stub
gail schoettler	Stub
rudolph bunner	C
marcia hovey-wright	Stub
stephen dinatale	Start
debbie rodella	Start
george troup	C
lloyd bryce	Start
bradley byrne	C
vice chairman of the democratic caucus	Stub
linda ichiyama	Stub
thomas laurens jones	Start
gershom powers	Stub
eustace gibson	Start
george franklin drew	Stub
progressive internationalism: a democratic national security strategy	Stub
george whitefield	GA
new hampshire democratic party	C
charles wesley turnbull	Start
arkansas highway 180	C
john blackwell hale	Stub
matt ahearn	Start
pat gardner	Stub
mark davitt	Start
matthew cianciulli	Stub
tim wirth	C
mary morrill	Start
kelly hu	GA
edward franklin bingham	Start
lucas davenport	Start
ohio democratic primary, 2008	C
john milton niles	Start
doug duncan	C
mick thompson	Start
foung hawj	C
eileen filler-corn	Start
clay constantinou	Start
mike denham	Start
maud crawford	GA
aretha franklin	FA
democratic party presidential primaries, 2004	B
job pierson	Start
maria frica pangelinan	Stub
sylvia garcia	Start
samuel newell bell	Start
daily kos	C
alex knopp	Start
north carolina democratic primary, 2008	GA
amy klobuchar	B
perle mesta	Start
john ellis martineau	C
joanne giannini	C
joy hearn	Start
brent boggs	Start
lew frederick	Start
richard brodhead	Start
richard french	Stub
bob shrum	C
tyre york	Start
john alario	C
betsi devries	Stub
maryanne keller	Stub
rachel zenzinger	Stub
william gissberg	Stub
salvatore dimasi	C
cheryl coakley-rivera	Start
by the people: the election of barack obama	Stub
bill reardon	Stub
merrill connally	Start
hubert humphrey	FA
benjamin fitzpatrick	Start
joseph avellone	C
fats everett	Start
thomas moonlight	C
gene carmichael	Stub
nathaniel pitcher	Start
larry langford	C
rocco quattrocchi	Stub
katherine kazarian	Stub
bob butterworth	C
helen lemme	Start
alvin alden	Stub
jonathan larkin	Stub
harvey locke carey	GA
matthew birchard	Start
jeffrey evangelos	Start
jack christian	C
warren magnuson	GA
victor degrazia	Start
philip pendleton barbour	C
norris hoyt	Stub
paul clemente	Stub
henry dixon allen	Stub
john peavey	Start
taylor benson	Start
mike callaghan	Start
august belmont	C
nathaniel job hammond	Start
ed gruchalla	Stub
donovan olson	Start
william wirt hastings	Start
edward kavanagh	Start
william bennett fleming	Stub
brian griffin	GA
joyce cusack	Start
don barbieri	Stub
heidi heitkamp	C
patricia blevins	Start
join, or die	C
becky carney	Stub
william bachman	Stub
josh hartnett	GA
volney howard	Start
joseph martin crowley	Stub
cornelius lawrence	Start
jess larson	C
orestes brownson	C
charles francis murphy	B
national federation of democratic women	Start
derek kawakami	Stub
james arthur ewing	Stub
darrell mcgraw	C
ruth ann jamnick	Stub
wesley clark	GA
linda higgins	Start
william jennings bryan dorn	Start
gene rardin	Stub
david blount	Stub
javier aponte dalmau	Stub
bill vasey	Stub
virginia declaration of rights	C
billy kenoi	C
ben grussendorf	Start
joseph weeks	Stub
bob greive	Stub
karen camper	Start
daryl beall	Start
public policy polling	C
lamartine griffin hardman	C
luis alejo	Start
rolling stone	B
james joseph butler	Start
paul donato	Stub
statewide opinion polling for the january democratic party presidential primaries, 2008	C
george washington owen	Stub
bill daniel	C
doug gatewood	Stub
armond budish	C
judson allen	Start
redemption movement	C
john amari	Start
theresa two bulls	C
raleigh brown	Start
jyles coggins	Start
peter corroon	Start
jay fisette	GA
dave mcalpin	Stub
jerry abramson	GA
allen bares	GA
nolan mettetal	Stub
tom dart	C
chief vann house historic site	C
frank snow	Start
dave bing	C
william marshall inge	Start
chauncey fitch cleveland	Start
pam jochum	Start
beriah brown	Stub
nancy pelosi	GA
ignatius cooper grubb	Start
gordon berg	Stub
john kee	Start
george stephanopoulos	C
rosalyn baker	C
jimmy bales	Stub
creek war	FA
michael stivic	C
john ager	Stub
nancy lusk	Stub
thomas donegan	Start
sharon stewart-peregoy	Stub
bill hutchins	Stub
betty friedan	B
elias brown	Stub
wyoming democratic caucuses, 2004	Stub
edward mazurek	Start
james madalena	C
anastasia pittman	Start
virgil chapman	Start
denise harlow	Stub
kenny bowen	B
cyrus beers	Start
walter nathan tobriner	Start
mike doogan	Stub
rees bowen	Stub
kentucky democratic party	C
amasa walker	Start
broderick henderson	Stub
philemon thomas	Start
wilbur faiss	Start
bubber epps	Stub
david hubbard	Start
william waightstill avery	Start
john winston jones	Start
phillip archuleta	Stub
homer kandaras	Stub
william knight potter	Start
1932 democratic national convention	C
andrew jackson presidential campaign, 1828	GA
bill ritter	C
gary guear	Start
john wurts	Stub
alpheus sherman	Stub
lisa tomasso	Start
red hill patrick henry national memorial	Start
ike franklin andrews	Start
petticoat affair	B
anthony beale	C
james robert jones	C
dee caperton	Start
nebraska democratic party	Start
jay rockefeller	GA
hewitt bouanchaud	Start
ryan yamane	Start
francis burton craige	Start
ellie hill	Start
fort smith national historic site	Start
montgomery morrison cothren	Stub
buddy dyer	C
john conyers	B
sally clausen	C
william benton boggs	Start
henry hollingsworth	Stub
lottie beebe	C
ralph modjeski	C
michael debose	Start
edward fadeley	C
john gunyou	Start
arthur bowers	Stub
keith ingram	Start
aslag benson	Stub
tim carpenter	Start
dale cardwell	Start
frank kloucek	Start
james andrew beall	C
bill bradbury	C
jeb spaulding	Start
carl bergmanson	Start
marc anthony	C
andy dawkins	C
jabar shumate	Start
steve novick	C
jasper schneider	Start
bill clyburn	Stub
harriet elizabeth byrd	Start
jean lafitte	GA
james madison	B
juan arambula	Start
john fedo	Stub
ruben gallego	C
george washington hopkins	Start
andrew billow	Stub
alice clausing	Stub
james farrow	Stub
lois frankel	C
don ballard	Stub
charles tighe	Stub
william jennings bryan	B
william marmaduke kavanaugh	Stub
terrance carroll	Start
cynthia dill	C
joe fitzgibbon	Stub
michael sprinkle	Stub
meshea poore	Start
george dern	C
taylor harper	Start
msnbc	B
helio melo	Start
gregory costantino	Stub
jon lindgren	Start
brad henry	B
mary harris jones	GA
cardiss collins	Start
dudley mays hughes	Start
randy and sharon marsh	GA
hubert thomas delany	GA
james brown clay	Start
angela cockerham	Stub
edward dexter holbrook	Stub
kay floyd	Start
tim faust	Start
cyrus habib	C
frank eckels beltzhoover	Stub
frank weddig	Stub
bob duff	Start
thomas lanier clingman	C
southern democrats	B
bob bullock	C
anitra rasmussen	Start
adam huntsman	Start
thomas gangemi	Stub
erin herbig	Stub
robert gammage	C
greg solano	Start
frank estes cole	Start
1968 democratic national convention protest activity	C
nathan bedford forrest	B
harry britt	Start
randy gordon	C
steve lebsock	Start
ted bennett	Start
rich constable	C
horatio needham	Start
philip cortez	Start
matthew feldman	C
cindy bass	Stub
isaac gere	Stub
joe manchin	B
joseph lecompte	Stub
maurice bessinger	C
louis bostedo	Start
paul nesbitt	Start
force bill	Start
isaac mckim	Start
mike duggan	C
port royal state park	Start
bert marley	Start
coya knutson	C
george rockingham gilmer	Start
richard manning jefferies	Start
charles frederick crisp	Start
gloria tristani	Start
joseph de la cour	Stub
paul dennert	Stub
richard blumenthal	B
glen browder	C
mike espy	C
olivia de havilland	FA
john edwards presidential campaign, 2008	FA
fernando wood	C
lyle boren	C
jennings randolph	C
ratliff boon	C
lightning rod	B
william dotzler	Start
the newdeal	Stub
james fairman fielder	Start
wayne owens	Start
ethelbert barksdale	Start
homer stille cummings	C
joseph rosier	Start
chris dodd presidential campaign, 2008	FA
bob blumenfield	C
charles west kendall	Start
henrich focke	C
john judson ames	B
clement vallandigham	C
willa mccord blake eslick	Start
vance hartke	C
clinton babbitt	Stub
kevin dahle	Start
elliot anderson	Start
john edward kelley	Start
mary throne	Stub
african-american heritage of united states presidents	B
cruz bustamante	C
daniel akaka	C
fuller kimbrell	Stub
peter deutsch	C
joan hartley	Start
the way to wealth	Stub
union fire company	C
omar burleson	Start
don preister	Start
byron dorgan	C
diana degette	C
george wolf	Start
puerto rico democratic primary, 2008	C
edwin albert link	GA
harold metts	C
douglas dummett	C
john whiteaker	C
carl hayden	FA
courtney allen curtis	B
john neely bryan	C
washington monthly	GA
bill burlison	Start
carolyn hugley	Stub
autumn burke	Start
edmond noel	C
liz mathis	C
karen soli	Stub
ansel briggs	C
charles clarence neslen	Start
terry mcauliffe gubernatorial campaign, 2013	C
amanda mcgill	Start
new york city: the 51st state	B
barbara richardson	Start
henry conner	Stub
nathan soule	Stub
doug geiss	Stub
hiram raleigh kennedy	Start
charles francis colcord	FA
scott mccoy	Start
thomas irwin	Start
carter manasco	Start
les gara	Stub
alan butkovitz	C
tony bisignano	Start
walter burgwyn jones	Start
donald cookman	Stub
democratic national committee	GA
andrew grant chapman	Start
nick casey	Start
nathaniel edwin harris	Start
ron auer	Start
kenneth gagnon	Stub
august busch iv	C
samuel beardsley	Start
karen weldin stewart	Start
lincoln davis	C
bruce breslow	Start
wayne ehlers	Stub
samuel wright mardis	Stub
al juhnke	Start
richard busteed	C
tom fiegen	Start
john guire	Start
francis ford coppola	GA
dolores mertz	Start
john frank wilson	Start
fob james	C
don svaty	Stub
tommy wells	Start
louis caldera	C
brian egolf	Stub
loren acton	Start
teresa daly	Stub
carl sheeler	Start
phillip burton	C
bill bowen	Stub
james chrisman	Stub
louis coppersmith	Stub
judy chu	GA
alexander kerr craig	Stub
bob poe	C
samuel etheridge	Start
arbuthnot and ambrister incident	Start
timothy cullen	Start
scott slater	Start
doc bryan	Stub
allan kauffman	Stub
thomas gore	C
patrick botterman	Stub
narden jaime espinosa	Start
ellen spiegel	Start
amanda simpson	C
bill dieleman	Stub
ron kouchi	Start
james abourezk	C
john mckinley	Start
dave crooks	Start
irene aguilar	Stub
michelle kidani	Start
montana democratic party	Start
herbert arlene	Stub
oliver max gardner	C
fannie lou hamer	C
eugene housley	Stub
george hubert bates	Stub
oliver bascom	Stub
shenna bellows	C
richard irvine manning iii	Start
james ohrenschall	Start
rick dantzler	Stub
lynne pancrazi	Start
warren babcock	Start
clintonism	Stub
matt kisber	Start
mike mcgrath	Start
nicole lefavour	C
samuel dinsmoor	C
john myers felder	Start
ellis arnall	C
harland bradley howe	C
brian moran	C
billy graham	GA
archibald hill carmichael	Start
dennis callahan	Start
marion barry	GA
dave gallik	Stub
dennis mahony	Start
neil abramson	Start
kenneth mcclintock	B
millie hamner	Start
curt levine	Start
bette davis	B
percy priest	Start
jeffrey coy	Start
bradley maxon hamlett	Stub
joe neal	Stub
bill gluba	Start
bryan sharratt	Stub
john brewer brown	Stub
jean schodorf	C
john sebastian little	Start
2004 democratic national convention speakers	B
john francis hamtramck claiborne	Start
jeff danielson	Start
daniel linn gooch	Stub
jerry denbo	Stub
armand brinkhaus	C
bennet bicknell	Start
diane sands	Start
linda chesterfield	Start
daniel gould fowle	Start
robert cullenbine	Stub
raymond gallison	C
clayton halverson	Stub
kate cloonen	Stub
maria cimini	Start
paul bitz	Stub
warren mcgraw	Start
2004 democratic national convention keynote address	B
marvin abney	Start
jerry henry	Stub
parker watkins hardin	GA
john oceguera	Stub
theodore conkey	Stub
frank henry cooney	Start
jennie robak	Stub
junius hillyer	Start
michael sanchez	Start
tauese sunia	Start
linda bebko-jones	C
karen bass	C
kyle yamashita	Start
abraham rencher	Start
list of places named for andrew jackson	Start
john thomas caine	Start
buddy leach	C
john desimone	C
gary decramer	Start
al edwards	Start
carolyn meline	Stub
dwight jensen	Stub
rodney glassman	C
ion farris	C
harry mitchell	C
mary caferro	Stub
michael ashford	Start
jedediah peck	Start
bill baxley	C
100-hour plan	C
edward degraffenried	Start
dennis conta	Stub
thomas dunn english	C
warren chisum	C
baldwin 60000	Start
bob hanner	Stub
tobias barry	Start
james von der heydt	Start
mary glassman	Start
roberta beavers	Stub
dale cassens	Stub
jessica farrar	Start
isaac fletcher	Start
samuel clark	Stub
bryant thomas castellow	Start
matilda hansen	Stub
happy chandler	FA
lorie masters	GA
palmer depaulis	Stub
denny coffman	Start
tim cosgrove	Start
george dodge	Start
allen boyd	C
bill delahunt	C
powhatan ellis	Start
the american prospect	C
vanessa guerra	Stub
pete buttigieg	C
reggie joule	Start
george holcombe	Start
waco: a new revelation	Stub
peter bartzen	Stub
robert franklin armfield	Start
paul fogarty	C
nancy-ann deparle	C
jane ballard dyer	Start
richard ervin	Stub
samuel caruthers	Start
edith mcclafferty	Stub
hugh gallen	Stub
the first civil right	Start
pat brown	B
samuel augustus merritt	Start
charles burson	Start
henry braden	Start
carlos bee	Start
edmund strother dargan	Start
brandeis university	GA
robert stockton green	Start
julius caldeen gunter	Stub
lyncoya jackson	Start
wayne connally	C
mo udall	C
jody dickinson	Start
perkins king	Stub
john bigelow	C
jeff eldridge	Start
bill vidal	Start
creigh deeds gubernatorial campaign, 2009	GA
lester hyman	C
wanda soler rosario	Start
modern liberalism in the united states	B
esther harrison	Stub
seth goodall	Start
victor wickersham	Start
andy griffith	GA
shane cohn	Start
didi barrett	Stub
john conrad bucher	Stub
lynda moss	Stub
irwin brownstein	Start
max baucus	B
ed austin	C
heather giugni	Start
jim pederson	C
thomas lilbourne anderson	Start
james hopkins adams	C
berkley bedell	GA
sharon davis	Start
tim russert	GA
tom harkin	GA
john baldacci	C
thomas bragg	Start
henry wilbur bentley	Start
virgil bernero	C
carl hendrix	Stub
joan finney	Start
louis berry	Start
rocky lara	Start
george law curry	C
john lisnik	Stub
mario biaggi	C
champ clark	C
lathrop brown	C
john wisniewski	C
new organizing institute	Start
gretchen kafoury	Start
harry reid	B
louis gladstone	Start
curtis hertel	Stub
evan bayh presidential campaign, 2008	FA
william schuelein	Stub
joe haussler	Stub
kevin killer	Start
statewide opinion polling for the march democratic party presidential primaries, 2008	Start
egbert ten eyck	Start
democratic party of oregon	B
jeff jamar	Start
dean acheson	C
matt santos	C
wayne coy	Stub
vicki miles-lagrange	Start
duke bainum	C
virgil fludd	Stub
martha coakley	GA
spencer frye	Stub
bill hilty	Start
jim lykam	Stub
samuel bunch	Start
joel west flood	Start
melancton smith	Start
erika geiss	Stub
graham arthur barden	Start
oregon democratic primary elections, 2008	C
timothy cullerton	Stub
joseph cryan	C
harold janeway	Stub
george farmer burgess	Start
james edwin belser	Start
aaron vanderpoel	C
herschal crow	Stub
manuel flores leon guerrero	C
benjamin gwinn harris	Start
glass harmonica	B
barack obama presidential primary campaign, 2008	GA
earl blumenauer	GA
ken casey	C
walt dziedzic	Start
peter hansborough bell	C
mike manypenny	Start
joshua jewett	Stub
randolph collier	Stub
aaron harding	Start
bill clay	Start
douglas applegate	Start
donald lally	Start
theron akin	Start
harry bronson	Start
angela mclean	Start
hodding carter	C
stephen six	C
eugene england	C
andre agassi	B
bonnie watson coleman	C
bryce edgmon	Stub
ed lindquist	Stub
maryland democratic primary, 2008	Start
peter cooke	Stub
paul aizley	Start
richard mcmullen	Start
robert franklin bratton	Start
greg orman	GA
fred cowan	Start
jack lund schofield	Stub
elaine baxter	Start
john gary evans	Start
nick colafella	Stub
bernard lyot	Start
locke craig	Start
mark dayton	GA
ruth ann gaines	Start
andrew ketterer	Stub
clayton klein	Start
arne duncan	C
lynda lovejoy	Start
macdonald gallion	Start
geri huser	Start
harvey helm	Stub
stephanie garcia richard	Start
art alexakis	C
hernando money	Start
arthur torres	Start
barack obama election victory speech, 2008	C
john sudam	Stub
jesse clason	C
joseph mackey brown	Start
pete jarman	Start
carol shea-porter	GA
charles james faulkner	Start
bill anoatubby	C
carol kontos	Stub
ed chau	Stub
william henry bissell	Start
joe garcia	C
deborah arnie arnesen	Stub
kent rogert	Stub
marilyn dondero loop	Start
joseph berrios	GA
modesto agosto alicea	Start
nathan deal	GA
dixiecrat	GA
john crompton weems	Stub
charles marley anderson	Start
james kee	Start
bruce king	Start
dennis cohoon	Start
sylvia larsen	Start
james bowler	Start
rafael surillo	Stub
nancy jacobson	Start
otis colwell	Start
roy elson	Stub
matti herrera bower	Start
rick olson	Start
jessica fitzwater	C
erin lynch	Start
jannie blackwell	Start
roberts hall	Stub
james alexander daugherty	Start
sam seaborn	C
howell cobb	C
harry bauler	Stub
sidney preston osborn	Start
david brock	C
susan gaertner	C
chris harker	Start
neil goldschmidt	GA
wilbur lucius cross	C
wilma chan	C
guy padgett	Start
kenneth cooper alexander	C
brian colon	Start
jack burtch	Stub
hiester clymer	Start
the third terrorist	Start
harry lane	GA
elijah cummings	C
marie babka	Stub
mickey kantor	Start
california democratic party	GA
julian castro	GA
pete festersen	Start
ken boles	Stub
george washington bolton	Start
kreg battles	Stub
mary mancini	Stub
norman albert mott	Start
william tharp	C
bill bogaard	Start
wirt bowman	Start
vinson allen collins	Start
1940 democratic national convention	GA
jamescita peshlakai	Start
james robert claiborne	Stub
vince foster	GA
american terrorist	Start
richard honaker	B
albert galliton harrison	Stub
marc alessi	Start
lewis preston collins ii	Start
warren buffett	B
jane byrne	C
chris coons	GA
jones osborn	Stub
idaho democratic party	Start
crystal snow jenne	Start
freman hendrix	C
chuck benedict	Start
ira sprague bowen	Start
augustin smith clayton	Start
frank melton	C
homer lenderman	Start
mysterious dave mather	C
ami bera	GA
john tolley hood worthington	Stub
joseph coniglio	Start
thomas docking	Stub
francis biddle	C
silence dogood	Start
george caleb bingham	C
beth edmonds	Start
robert john cornell	Start
murray chotiner	FA
charles chvala	Stub
michael bennet	GA
randolph carpenter	Start
judy feder	Start
maysville road veto	C
battles of emuckfaw and enotachopo creek	Start
roy neighbors	Stub
colleen bell	GA
douglas mintz	Start
sol luis fontanes	Start
thomas montgomery bell	Stub
warren beatty	GA
william riley dunham	Start
robert correia	Stub
phil riesen	Stub
john mckeon	Start
henry keyes	Stub
anton gunn	C
roy cooper	C
alan canfora	Start
hodding carter iii	Start
vargrave richards	C
laurie monnes anderson	Start
tom udall	C
james franklin clay	Stub
susan mclain	Start
mark hackel	C
dick greuel	Start
riemer calhoun	C
mary kincaid-chauncey	Start
wyche fowler	Start
denver 2008 convention host committee	Start
charles peter mccolough	C
mac collins	Start
george jacob benner	Stub
debbie wasserman schultz	B
maxine moul	Start
steve lathrop	Stub
jim henson	GA
mike berlon	Start
janice cooper	Stub
louisa johnson	GA
nathan bristol	Stub
martin mcnulty crane	Start
tim ayers	Start
robert giaimo	Start
henry cornelius burnett	FA
chittenden lyon	Stub
karen castor dentel	Start
edward saatchi	Start
george street boone	Start
ben and me	Start
fernando bonilla	Start
percy lee gassaway	Start
john ladenburg	Start
albert constable	Stub
aylett hawes buckner	Start
joe atkins	Start
john bullock clark	Start
steve hildebrand	Start
noah martin	Start
the complete anti-federalist	Start
grace towns hamilton	GA
doreen gallegos	Stub
anton cermak	C
larry hosch	Start
bernhart henn	Start
william addams	Stub
sheila klinker	Stub
mike gravel	FA
deborah jeanne dawkins	Start
franklin cannon	Start
ephraim leister acker	Start
clay stone briggs	Start
shockley shoemake	Stub
charles flaherty	Start
dan schmidt	Start
harris wofford	GA
terry nichols	GA
andrea wyatt	Start
william henry ashley	C
brereton jones	FA
sherman copelin	Start
lawrence brock	Stub
melissa harris-perry	C
bill clinton presidential campaign, 1992	C
ausburn birdsall	Start
dave ceccarelli	Stub
rocco colonna	Stub
emerson harrington	Start
blythe ferry	Start
nancy floreen	GA
edward everett grosscup	Start
joe buscaino	C
ray begaye	Stub
stacey abrams	C
mia mcleod	Start
leslie knope	GA
dom costa	C
james donnewald	Start
felipe aguirre	Stub
daniel wardwell	Stub
barb goodwin	Start
national jewish democratic council	C
emily sophia tanner richards	Start
michael sirotkin	Stub
cliff finch	Start
mike monroney	Start
blake oshiro	Start
john bessler	Start
francisco zayas seijo	C
joel keith mann	Stub
kathy haigh	Stub
william comstock	Start
clay dixon	Stub
william lewis douglas	C
joe geller	Start
iris faircloth blitch	Start
neil bluhm	C
montfort stokes	Start
ed hatchett	Start
adrian polansky	Start
john roane	Start
frank annunzio	Start
archibald yell	C
david wu	C
ezell lee	Stub
alan grayson	GA
peter shumlin	GA
kathleen brown	Start
debbie marquez	C
george henry williams	GA
patrick cannon	C
lloyd doggett	C
james lent	Stub
john brisbin	Stub
robert jones atkinson	Start
mel carnahan	C
steve vaillancourt	C
francis cockrell	C
noam bramson	C
christopher cockerell	C
arthur handy	Start
ann kirkpatrick	C
steve gallardo	C
nick rahall	C
jonette engan	Start
wanda jo peltier	Start
joe hardage	Stub
organizing for america	C
james david cain	C
pat danner	Start
leo bartoline	Stub
wilson shannon	C
bob kressig	Start
phanor breazeale	Start
benjamin franklin	B
roy herron	C
herbert william christenberry	Start
bobby joe champion	Start
larry christman	Stub
wyoming democratic caucuses, 2008	C
larry wiley	Start
united states presidential election in iowa, 1988	Start
dorothy bendross-mindingall	Stub
elijah hise	Start
julia brownley	C
cliff ammons	C
harryette ehrhardt	Start
samuel rexford	Stub
eli hunt	Stub
travis childers	C
ole aarsvold	Stub
joseph toole	Start
tim moran	Stub
joshua baker	Start
george washington hays	Start
julia butler hansen	Start
john mckee	C
joe mcelveen	Stub
rubel phillips	B
bill stetson	C
guy dailey	Start
trail of tears state park	Start
joe levins	Stub
carrol orrison	Stub
poindexter dunn	Start
thomas glascock	Start
united states presidential election, 2008	FA
enrique campos del toro	Start
bruce botelho	C
richard randolph mcmahon	Start
james duane doty	C
minthorne tompkins	Stub
francis seger	Start
benny ray bailey	Stub
1864 democratic national convention	C
jon tester	GA
mandela barnes	Start
lewis dewart	Stub
frederick lawton	GA
alyce clarke	Stub
thomas banks cabaniss	Start
john mauchly	C
ponka-we victors	Start
myrlie evers-williams	GA
sargent shriver	C
wayne palmer	C
deedee corradini	Start
demetrius atsalis	Start
suzanne bonamici	C
john culver	Start
john heritage bryan	Stub
red clay state park	Stub
house trade working group	Start
arizona democratic primary, 2008	Start
jessie ulibarri	Stub
paul contillo	Start
list of asian pacific american democrats	Start
keen johnson	GA
james william denny	Start
charles allen culberson	Start
thomas maxwell	Start
jill alper	Start
jennifer haase	Start
kimberly campbell buck	Stub
fran coleman	C
ray farabee	GA
antonio cabral	Start
mickey channell	Stub
peter groff	C
alphonse roy	Start
blondell reynolds brown	C
martin van buren	GA
jeanne dost	Start
jeremiah henry murphy	Start
charles bodle	Start
john kincaid	Stub
robert king high	GA
richard onishi	Stub
jim matheson	C
frank lombardi	Stub
harold eugene edgerton	C
ezra meech	Start
mark udall	GA
george welshman owens	Stub
jean guy	C
william tecumsah avery	Start
college democrats of america	C
marion gressette	Stub
ryan dvorak	C
gil kahele	Start
skip daly	Start
jeremy harris	C
a dissertation on liberty and necessity, pleasure and pain	Stub
watkins moorman abbitt	C
popular democratic party of puerto rico primaries, 2008	C
rush limbaugh is a big fat idiot and other observations	Stub
john mason martin	Stub
jay paul gumm	Start
will bond	Start
mike johanns	GA
chet culver	C
gerard conley	Stub
nick barborak	Stub
kevin costner	B
kerry burt	Stub
chuck franco	C
angela giron	C
jay ash	C
walter coles	Stub
sharon sayles belton	C
tim eustace	Start
guy drexinger	Stub
chuck baldwin	B
david adelman	C
clinton presba anderson	C
david schapira	Start
list of united states democratic party presidential tickets	C
patrick goggles	Stub
doris haddock	C
donna cooper	Start
michael futrell	C
alexander monroe dockery	C
tom burroughs	Start
lou frost	C
frank church	FA
pete ashdown	Start
george loyall	Start
the progressive	C
barbara lett-simmons	C
diane lanpher	Stub
george nigh	GA
ollie murray james	Start
richard swett	C
albert kookesh	Start
ed fallon	C
jacques cousteau	C
marv hanson	Stub
ken cooley	Start
jay chevalier	C
stephen magie	Start
calvin britain	Start
ryan maher	Stub
matthew dowd	C
john seaton robinson	Stub
peggy lamm	Stub
norberto soto figueroa	Stub
scott cowger	Start
john cullerton	Start
barnabas kelet henagan	Start
yvonne brathwaite burke	C
judy kany	Stub
elisabeth jensen	C
elfreda higgins	Start
mary richards	C
mr galloway goes to washington	Stub
charles robert borchers	C
thomas whitfield davidson	Stub
karen mayne	C
dennis kucinich presidential campaign, 2008	C
randall patterson	Stub
julie french	Stub
ray herbert talbot	Stub
1888 democratic national convention	Start
bob stupak	C
nicholas fernicola	Start
indian removal	B
jon bon jovi	C
jean price	Stub
randy bass	C
21st century democrats	C
duane hall	Stub
al gore presidential campaign, 2000	GA
amanda curtis	C
raymond sullivan	Start
kentucky democratic primary, 2008	Start
ken miyagishima	Start
james farley	C
laura thielen	Start
clarence bradford	C
gary kubly	Start
gene kennedy	Stub
hector craig	Start
stephen ucci	Start
jerry brown	GA
jimmie lee	Start
springfield to fayetteville road-elkhorn tavern segment	Stub
texas college democrats	Stub
christopher hurst	Stub
thomas buck reed	Start
marie herbst	Stub
earnest brown	Stub
ima wells	Stub
trudi schmidt	Stub
joe baca	C
webster davis	Start
edgar gillock	Stub
deadheads for obama	Start
bill maher	B
ferdinand brucker	Stub
united states presidential eligibility legislation	B
declaration of rights and grievances	Start
bill faison	C
leland beloff	Start
tom strickland	C
ryan deckert	Start
george darden	C
edward echols	Start
harry teague	C
oklahoma city bombing	GA
garrett bradley	Start
connecticut democratic primary, 2008	Start
martin david kruskal	C
mattox hair	Stub
clement laird brumbaugh	Start
janice cole	Start
niilo koponen	Start
jonathan rothschild	Stub
cynthia stone creem	Stub
terry bean	C
peter bock	Stub
dale swenson	Start
walter capps	Start
harold brazil	Stub
marc draisen	Stub
lynda carter	GA
coffin handbills	C
craig eiland	Start
jeff mccabe	Start
richard merrill atkinson	Start
curley byrd	GA
brad dye	Start
lucius benedict peck	Start
1840 democratic national convention	Start
branden durst	C
bart gordon	C
william darius jamieson	Start
julian carroll	GA
edward john phelps	C
job mann	Start
johnathan mccarty	Start
mark hass	C
veronica grace boland	Stub
kerry gauthier	C
terri bonoff	C
richard croker	C
deborah fellela	Start
asa biggs	Start
popular democratic party of puerto rico primaries, 2003	Start
harold donohue	Start
emerson beauchamp	Stub
esther gordy edwards	Start
mary lou dickerson	Start
alice hausman	Start
walter halben butler	Start
alexander cornell du houx	C
robert docking	Start
jesse atherton bynum	Stub
rob hogg	Start
george ticknor curtis	Start
dave mccurdy	C
1904 democratic national convention	C
heidi davison	C
bob bischoff	Stub
grant sawyer	C
wayne ford	Start
sheryl williams stapleton	Start
angus mckelvey	Start
kenny guinn	Start
joe mceachern	Stub
vivek kundra	GA
thomas croxton	Start
hector balderas	C
liz lemon	FA
jennifer elkins	Stub
geoff luxenberg	Start
james paul clarke	Start
benjamin babock thurston	Start
california democratic primary, 2000	Start
maria baez	Start
richard ben-veniste	Start
jerry janezich	Stub
lincoln clark	Start
roland burris	B
bruce maloch	Start
dave freudenthal	Start
stephen canessa	Start
adam ebbin	Start
mary cirelli	Stub
jeff greene	C
sean tevis	C
gary trauner	C
sol kahoohalahala	Stub
james nesmith	C
herman badillo	GA
bertrand kobayashi	Stub
ed rendell	B
vera katz	C
roberta achtenberg	Start
james bradley orman	Start
thomas jefferson lilly	Start
robert light	Stub
thurbert baker	C
adam goode	Stub
tony bouza	Start
ernest mcfarland	C
young democrats of utah	Start
democratic party of georgia	C
kimberly alexander	Stub
winfield scott hancock	FA
larry echo hawk	C
william davis daly	Start
justin chenette	C
robert humphreys	Stub
william schley	Start
united states presidential election in florida, 2000	C
chet king	Stub
della au belatti	Start
william frick	Start
jack connell	Stub
lauchlin bethune	Stub
ken guin	Stub
mike capuano	GA
james allen graham	Start
william woods holden	C
francis baylies	Start
ken hechler	C
george dromgoole	Start
john alexander mcclernand	C
beth bernstein	Start
jesse hoyt	Start
district of columbia democratic primary, 2008	Start
hunter andrews	Start
joe bertram	Start
jeff woodburn	Stub
dan tangherlini	C
william gordon brantley	Stub
hardy myers	GA
locofocos	C
ro foege	Start
lambert hehl	Stub
enoch chase	Start
alfred goldthwaite	Start
victoria gray adams	C
zadok casey	Start
thomas caltagirone	Start
asian american action fund	C
bulworth	C
roberto vigoreaux	Start
carroll hubbard	Start
susan wismer	C
donald fowler	Start
mabel desmond	Stub
john telemachus johnson	Start
troy heinert	Start
andrew kandrevas	Stub
matthew denn	C
creigh deeds	C
justin bamberg	C
sean faircloth	GA
barack obama presidential campaign, 2008	GA
teller ammons	Start
jon corzine	B
jim esch	Start
willie bailey	Stub
oklahoma democratic primary, 2008	Start
frank brouillet	Stub
list of gubernatorial nominees from the popular democratic party of puerto rico	Stub
lon horiuchi	C
charles harvey denby	Start
leroy collins	C
stonewall young democrats	C
anthony caminetti	Start
california democratic primary, 2004	C
robert latham owen	B
gene fraise	Stub
samuel cootes	Stub
helen boosalis	Start
sandy cohen	C
jeff arnold	Start
tal hutchins	Stub
lin whitworth	Stub
jim jontz	C
1928 democratic national convention	Start
robert ward johnson	C
ashley judd	B
robert taylor jones	Stub
preston daniels	Start
victor salazar	Start
sara gideon	Stub
walter walford johnson	Start
john newman edwards	C
democratic party of connecticut	Start
harvey gantt	Start
chris brase	Stub
macario saldate	Start
james patrick leamy	Start
gilda jacobs	Start
tommy dickerson	Stub
larry glenn	Stub
bob buckhorn	C
kevin craig	Start
mary messier	Start
lucien lester ainsworth	C
wayne holland	Start
edward beard	Start
earle cabell	Start
john foust	C
craig fugate	GA
oliver cowdery	B
carmelo garcia	Start
polk laffoon	Start
americans for democratic action	C
edmund billings	GA
washington-franklin issues	FA
samuel friedel	Start
tom burch	Start
andrew stevenson	C
christie benet	Start
matt lesser	Start
democratic national convention	C
carol alvarado	Start
shailagh murray	Stub
charles aberg	Stub
ryan degraffenried	Start
andy berke	C
rick palacio	Start
thomas jefferson	FA
2016 democratic national convention	GA
newton nash clements	Stub
lindy boggs	C
john pat fanning	Stub
william bernard barry	Start
nelson albano	Start
guy guzzone	Start
jeanne nicholson	Stub
erbey satterfield	Stub
dale bolle	Start
johnston murray	C
william claiborne dunlap	Start
debbie boyd	Stub
susan duckworth	Start
brittany pettersen	Start
paul ralston	C
takashi ohno	Stub
brianne nadeau	C
maralyn chase	Start
henry millin	C
david magleby	Start
jonathan jennings	FA
charles donald jacob	Stub
martha keys	Start
shelley adler	Start
sepia mutiny	C
john deberry	Start
ben nelson	B
sherry palmer	C
patty pansing brooks	B
jody amedee	Start
delano lewis	C
espy van horne	Stub
jim sherow	C
clement dowd	Stub
delaware democratic primary, 2004	Start
william barton wade dent	Start
michael doran	Start
vermont democratic primary, 2008	B
ted bottiger	Stub
arthur callow	Stub
tristram shaw	Stub
valdenia winn	Start
oscar goodman	C
alexandre mouton	Start
thomas hartley crawford	Stub
abel john evans	Stub
lucio fernandez	GA
jefferson davis	FA
eugene mccarthy	C
mo cowan	GA
joe lieberman	B
karan english	Start
bernard joseph leddy	Start
milack talia	Stub
philander stephens	Stub
ed fortune	Stub
daniel brewster	C
list of barack obama presidential campaign endorsements, 2008	B
dick morley	Start
robert patterson clark wilson	Start
steve street	Stub
moe maestas	Start
milt earnhart	Stub
george bachrach	Start
ross bass	Start
franklin medal	Start
stratton taylor	Start
seminole wars	FA
michael san nicolas	B
david lee jordan	Stub
richard conlin	C
pat hays	Start
albert boutwell	Start
nick coleman	Start
manuel herrera	Stub
georgia lee lusk	Start
wesley clark presidential campaign, 2004	B
james benton grant	Stub
george creel	B
phil bartlett	Start
steve gallus	Stub
sandy keith	Start
democratic caucus vice-chairman of the united states house of representatives	Stub
democratic party of illinois	Start
clemente agosto	Stub
william luther hill	Start
maria del carmen arroyo	Start
craig hickman	Start
lyla berg	Stub
bill ayers 2008 presidential election controversy	GA
jacksonian democracy	GA
west virginia democratic primary, 2008	Start
elias nelson conway	Start
carol rice allen	Start
richard henry wilde	Start
olivia cajero bedford	C
risden tyler bennett	Start
benjamin brandreth	GA
michael embrich	Start
angie buhl	Start
dick dearden	Start
don cooney	Start
george franklin fort	Start
albert gallatin hawes	Stub
john franklin alexander strong	Start
ray janssen	Stub
ben shelly	C
gorham parks	Start
james holt clanton	C
national organization for women	B
tod bowman	Start
willis holly	Stub
stan valchek	C
peter kilmartin	C
jay wright forrester	C
ola babcock miller	Stub
truman chafin	Start
mary sattler	Start
oscar lee gray	Start
marvin york	Stub
meyer alterman	Stub
washington state democratic party	Start
rebecca millett	Stub
amos lane	Start
new deal coalition	B
democratic party presidential primaries, 1960	C
jeremiah mclene	Start
vicki cocchiarella	Stub
ben cardin	GA
matt trieber	Start
dan forestal	Stub
mounce gore butler	Start
theresa abed	Stub
lacy landers	Stub
raymond joseph cannon	Start
melissa hortman	C
bruno ramos	Start
david dutremble	Stub
curtis wolfer	Stub
indian removal act	C
elizabeth furse	C
newspaper endorsements in the united states presidential election, 2008, for barack obama	B
steve zaiser	Start
1829 state of the union address	Stub
byron brown	GA
nan wood honeyman	Start
drew edmondson	C
miro weinberger	Start
bobby baker	GA
john rusche	Start
democrats for education reform	Start
thomas walker gilmer	C
charles ginsburg	Start
chuck espy	Stub
johnny ellis	Stub
dick barry	Stub
robert archer cooper	Start
1836 state of the union address	Stub
michael copps	Start
angel santos	Start
jesse crenshaw	Start
cornelius edward gallagher	Start
stephanie hannon	Start
benjamin chew howard	Start
yvette alexander	Start
stella hackel sims	Start
postage stamps and postal history of the united states	B
beth mccann	Start
debbie dingell	C
finly hutchinson gray	Start
linda pritzker	C
frederick simpson deitrick	Stub
kevin mannix	C
martha griffiths	C
marcus brandon	Start
marlon brando	B
samuel augustus bridges	Start
french strother	Start
edward isaac golladay	Start
clarence dupnik	Start
jeanne windham	Stub
albany antifederal committee	Stub
nickie antonio	C
lanny davis	C
hopkins holsey	Start
david bragdon	C
jessyn farrell	Stub
charles hanlon	C
elizabeth warren	GA
ingvald conrad thoresen	Stub
timothy shriver	C
1912 democratic national convention	C
willis brewer	Stub
parey branton	GA
al franken	GA
robin belcher	Stub
joe donnelly	GA
brooks brothers riot	C
oletha faust-goudeau	C
michigan democratic caucuses, 2004	Stub
nicole lowen	Stub
mike gabbard	C
john dillard bellamy	Start
rushern baker	Start
high school democrats of america	Start
brian blake	Stub
debra hilstrom	Start
anne slaughter andrew	Start
owen aspinall	C
pete crossland	Start
asa clapp	Stub
william hathaway	Start
new democrat coalition	C
wilburn cartwright	Start
curry carter	Start
reecy dickson	Stub
kurt schrader	C
paul baumbach	Stub
roberto rivera ruiz	Start
tony gabaldon	Start
monica lindeen	C
kenneth carano	Stub
russ carnahan	C
joseph taggart	Start
joel briscoe	Start
boyd petersen	C
al burruss	Stub
cotton hayden allen	Stub
gailanne cariddi	Stub
letters of centinel	Stub
william grason	Start
elaine beech	Stub
uno lamm	Start
harold haugh	Stub
ernesto ramos antonini	C
eileen donoghue	C
patrick kirschman	Start
susan bass levin	Start
wilson lumpkin	Start
jennifer williamson	Stub
jeff gilmour	Stub
1876 democratic national convention	C
hugh wade	Stub
guy brewer	C
elton bomer	GA
franks hall	Start
chauncey forward	Start
eleanor roosevelt legacy committee	Stub
louis brownlow	GA
alissa keny-guyer	Start
david hollister	Start
bea arthur	B
frederick george bromberg	Start
jacob gabriel	C
harry hibbard	Start
robert marion berry	C
david karem	Stub
hank johnson	B
brenda clack	Start
louis greenwald	Start
don czarcinski	Stub
chuck welke	Stub
moccasin bend	C
andrew jackson	FA
linda finn	Stub
steven baddour	Stub
jeanne labuda	C
charles caputo	Stub
mary babnik brown	GA
edith ajello	C
matt barrett	Start
democratic senatorial campaign committee	C
vincent bugliosi	C
eugene millerick	Stub
howie morales	Start
glenn olds	Start
sonny callahan	Start
charles peters	C
jim graves	C
james amann	C
christine donisthorpe	Stub
charles hopper gibson	Start
ron beitelspacher	Start
wayne knox	Stub
sagebrush rebellion	C
larry carp	Start
muscoe russell hunter garnett	Start
james ponder	C
henry hubbard	C
burwell boykin lewis	Start
jacob pitzer cowan	Stub
pauline lafon gore	Start
marc cote	C
ralph julian rivers	Start
edward everett eslick	Start
ana frohmiller	Start
chester ashley	Start
juggie heen	Stub
julius houseman	C
tim barnes	Stub
samuel beall	Start
rutt bridges	Start
hinda miller	Start
william campbell preston breckinridge	C
joe beimel	C
eugene coon	C
ralph lenhart	Stub
harris flanagin	Start
granville henderson oury	C
bella abzug	C
angela alioto	C
will coursey	Start
david axelrod	GA
statewide opinion polling for the february democratic party presidential primaries, 2008	Start
john hervey crozier	C
eric palmer	Start
thorn lord	Start
ted risenhoover	Start
john marshall hewitt	Stub
john espinoza	Start
william henry gist	Start
1900 democratic national convention	Start
mildred barry garvin	Start
jennifer dougherty	C
tunstall quarles	Start
kelly flood	Start
gideon tinsley	Stub
dan glickman	C
wyoming democratic party	Stub
bifocals	C
william drayton	C
floyd hicks	Start
cale keable	Start
allison copening	Start
stephanie herseth sandlin	C
jorge colberg toro	Start
jacob brinkerhoff	Start
tammy duckworth	GA
mike lowry	Start
james hutchins johnson	Stub
joel chaisson	C
cheri bustos	C
joseph wilson ervin	Start
port royal, tennessee	Start
marion de vries	Start
new echota	C
john andrew martin	Start
jesse root grant	Start
aaron broussard	C
robert belfanti	Stub
juan pichardo	Start
barbara fleischauer	C
christine trujillo	Start
frederick bruggerhof	Stub
ben franklin effect	Start
barbara roberts	C
joseph bonetto	Stub
calvin say	Start
1884 democratic national convention	Start
max bachhuber	Stub
orville freeman	C
patty judge	C
meredith calhoun	Start
robert billiot	Start
mount carmel center	C
jessica wooley	Start
bennion spencer	Start
andy anders	Start
stephen adamini	Start
2008 democratic national convention	GA
brickwood galuteria	Start
kim monaghan-derrig	Stub
mack mcinnis	Stub
john denver	B
richard coke	C
victor callahan	Start
john mcclannahan crockett	Start
lambert estes gwinn	Start
tom ervin	Start
douglass houghton	C
benny shendo	Start
democrats abroad	C
daniel draper	Start
richard walker bolling	C
olivia diaz	Start
dorothy bradley	Start
donna brazile	C
bettye davis	Start
king lysen	Stub
robert meza	Start
benjamin lafayette jefferson	Stub
leonidas raptakis	C
diana bajoie	Start
gene nichol	C
charles wyrick	Start
william bartlit	Stub
oliver belmont	C
nehemiah eastman	Start
william thomas bland	Start
tracy kraft-tharp	Start
david skaggs	GA
jill biden	GA
elijah gates	Start
faz husain	Start
robert klotz	Start
eleanor holmes norton	B
mark treaster	Stub
jimmy farris	Start
leon abbett	Start
phyllis busansky	Start
kathy davis	GA
erskine bowles	C
butler derrick	Start
tony curtis	B
josiah fisk	Stub
jack ascherl	Stub
jere cooper	Start
lilburn boggs	C
keith langseth	C
anna tovar	Start
ruth balser	Start
jan wyers	Stub
nicoll halsey	Stub
curtis boozman	Start
francis condon	Start
juan pan guerrero	C
sherwood dixon	Stub
cecil bothwell	C
george washington buckner	Start
john dingell	B
tim eichenberg	Start
joel brunsvold	C
louis mclane	C
preston leslie	GA
reuben knecht bachman	Stub
rick miera	Stub
ruben kihuen	C
david wilhelm	C
donna mercado kim	Start
james ferguson dowdell	Start
lyle hanson	Stub
ed case	C
carlton skinner	C
brian feldman	C
martha hughes cannon	C
dan gwadosky	Start
george jepsen	C
raymond johnston	Start
thad mcclammy	Stub
mary-jane foster	Stub
melanie meier	Start
george cassedy	Stub
charles harlow	Stub
stacie laughton	Start
dan cullinane	Stub
christine tartaglione	C
jon carpenter	Stub
william czar bradley	C
horatio king	Start
richard danzig	Start
wiley thompson	Start
bethine clark church	C
colorado democratic party	Start
edward boland	Start
john edwards	GA
hugh carey	C
ronald cowell	Stub
henry ashley	Start
mark begich	GA
richard codey	B
steve brozak	C
joe biden	FA
ludwig von mises	C
stuart starky	Start
united states one hundred-dollar bill	C
adam rankin alexander	Start
curt bowley	Stub
pushmataha	C
henry skillman breckinridge	Start
mike synar	C
mike foote	Stub
price daniel	GA
elma salinas ender	C
jacques piccard	C
willis eken	Stub
sue bell cobb	Start
kathleen burkett	Start
henry frye	Start
adlai stevenson ii	FA
william norton shinn	Stub
nick bain	Stub
1908 democratic national convention	Start
georgia democratic primary, 2008	Start
frank hornstein	Stub
karl rhoads	Start
agnes dobronski	Stub
roger hilsman	GA
scott ourth	Start
glenn english	Start
eni faleomavaega	C
barbara byrum	C
sheilla lampkin	Start
dawnna dukes	Stub
scott kawasaki	Start
franklin clark	Stub
alabama democratic primary, 2004	Stub
karl racine	GA
gary sherrer	Start
margaret doherty	Start
thomas taber ii	Stub
karla bigham	Start
james deleo	Start
harry cage	Stub
pete jorgensen	Stub
stephen archambault	Start
matthew harvey	Start
william lee knous	Start
samuel luccock black	Start
angel taveras	C
gertrude baines	Start
lisa heddens	Start
george griswold	Start
jerome cavanagh	C
guy gillette	C
william goodyear	GA
richard thomas walker duke	Start
henry burtt	Start
larry belcher	Start
ira anders	Stub
richard frymire	Stub
lafayette lane	Start
herb kohl	C
deborah berry	Start
organizing for action	C
mazie hirono	B
ted kulongoski	C
william goebel	GA
augustine dominguez	Start
thomas lee judge	C
ralph haben	C
alma adams	GA
joseph horace lewis	C
benjamin gratz brown	C
steve gaw	Start
lee beyer	Start
alvan cullom	Start
dennis feickert	Start
willie person mangum	Start
john jay lee	Start
franklin court	C
carlos vargas ferrer	C
beth nolan	GA
john bohlinger	Start
doug facemire	Start
asa earl carter	C
charlotte pritt	Start
charles box	Stub
jedd philo clark cottrill	Start
walton goggins	GA
brendan byrne	C
lee filer	Stub
asbury latimer	Stub
eugene semple	C
samuel mayall	Stub
ernest cunningham	Stub
carol gregory	C
carl hatch	Start
donelson caffery	Start
marie johns	Start
john perdue	Start
camille bennett	Start
dina titus	C
william nathaniel rogers	Start
wisconsin democratic primary, 2008	C
herbert fielding	Start
samuel mcclary fite	Start
national conference of democratic mayors	Stub
edward junius black	Start
virgil goode	GA
jack kibbie	Start
samuel edwards	Start
randy kelly	Start
robert williamson steele	Start
thinkprogress	C
henry selby clark	Stub
daniel dee burnes	Stub
arrington dixon	C
michael madigan	GA
gavin arthur	C
william yates atkinson	Start
fort hyndshaw	C
larry haws	Start
patrick leahy	B
robert weygand	Start
william chrisman	C
michael disalle	C
elton watkins	Start
john peter altgeld	C
jeanne shaheen	B
lowen kruse	Stub
win borden	Stub
ted celeste	C
willie stevenson glanton	Stub
christine kilduff	Stub
bill orton	C
abram fulkerson	C
second bank of the united states	GA
andrew gordon magrath	Start
sally jewell	GA
sara howard	Start
emily taft douglas	Start
terry goddard	C
michael morin	Start
max yashirin	C
charlene drew jarvis	Start
steve shurtleff	Start
fred durhal iii	Start
timothy lanane	Stub
sonia pacheco	Stub
henry horn	Stub
blue dog coalition	C
federal farmer	B
toby moffett	C
gary holder-winfield	Start
john dowdy	Start
eric croft	Start
sue schafer	C
gabrielle giffords	GA
ted kaufman	C
kate bolz	Stub
dennis cardoza	Start
brian doughty	Stub
bob ricks	C
harold michael	Stub
ruby laffoon	FA
ron dellums	B
parker griffith	C
william edward barton	Start
democratic party presidential primaries, 2000	C
charles downing	Stub
steven angelo	C
george eighmey	Stub
ulysses currie	Start
rick boucher	C
neil breslin	Start
john breaux	C
dow constantine	GA
1892 democratic national convention	C
michael curtin	Stub
anita decker breckenridge	Start
dwight dudley	Start
samuel daskam	Start
robin carnahan	C
jack irvin	Stub
jeff kessler	Start
nick begich	C
joseph albright	Start
birthplace of patrick henry	Stub
dolores furtado	Stub
nora lewin	Start
leonard bodack	Stub
georgene louis	Start
maria chappelle-nadal	C
sal didomenico	Stub
marcelo trujillo	Stub
lucy weber	Stub
james anthony galdieri	Start
gayle goldin	Stub
marci francisco	Start
dave aronberg	C
seth magaziner	C
john salazar	C
williamson robert winfield cobb	Start
alabama democratic primary, 2008	Start
terry carpenter	Start
sterling tucker	Start
john crawford crosby	Start
milton carpenter	Stub
terry goodin	Start
wesley bolin	Start
caleb tompkins	C
sunny dhoorh	Stub
albert bustamante	Start
james briden	Start
mel boozer	C
annie kuether	Stub
new jersey democratic primary, 2004	Stub
neva egan	Start
kyle schoenfish	Start
james benjamin aswell	C
debra delee	Stub
kathy brynaert	Start
wade hampton iii	C
kirk caldwell	Start
skip humphrey	C
lycurgus conner	Stub
william henry thompson	Start
joseph wheeler bloodgood	Start
valentine efner	Stub
bud clark	C
democratic vice presidential nomination of 1944	FA
brookins campbell	Stub
lester petrie	Stub
nathan cutler	Start
gottlieb garber	Stub
eugene elliott reed	Start
hubert collins	Stub
william montgomery churchwell	Start
stephen southmyd fenn	Start
deanna demuzio	Start
united states presidential election, 1832	C
jim bradford	Start
pasquale caggiano	Start
charles clement johnston	Start
jim carvin	Stub
andrew beaumont	Start
samuel ingham	Start
leopold caspari	Start
joseph hogan	Start
john joseph cavanaugh iii	Stub
wally horn	Start
william soules	Start
elizabeth brater	Start
brad oberhousen	Stub
norman hsu	GA
fort dupuy	Start
tommy irvin	C
eddie cheatham	Start
john conover nichols	Start
dominic jacobetti	Start
matthew dunlap	C
decimus et ultimus barziza	C
ed delaney	Start
kathy tyler	Stub
patricia carone	Stub
colgate darden	C
edna brady cornwell	Stub
william wirt adams	C
zeb alley	Stub
juanita goggins	C
1830 state of the union address	Stub
james floyd breeding	Start
jon leibowitz	C
sam ervin	C
alexander barkan	Start
robert tiernan	Start
david delano glover	Start
bernie agrons	Stub
michael jarjura	Start
samuel thurston	Start
paul hazen	Start
phylis king	Start
bill mauk	Stub
newt hudson	Stub
mark cardenas	Stub
frances munds	C
marlene johnson	Start
rhode island democratic party	C
jaime areizaga-soto	Start
john smith chipman	Start
lila sapinsley	Start
thomas eagleton	C
roger bruce	Stub
the huffington post	GA
erastus root	Start
steve cowper	C
democratic organizations	Stub
pat cannon	Start
tim manchin	Start
franklin bells	Start
maclyn goldman	Stub
johnny bell	Start
milton shapp presidential campaign, 1976	GA
linda phillips	Start
john astle	Start
geraldo alicea	Stub
lowndes henry davis	Start
nancy todd	Start
rida cabanilla	Start
daniel moreau barringer	Start
barry hobbins	Start
bekki cook	Start
lynn hornor	Stub
robert drinan	C
margarette leach	Stub
bryant clark	Start
anti-federalist papers	C
dave cieslewicz	C
orrin holt	Stub
elliott cresson medal	C
brenda council	Start
republican and conservative support for barack obama in 2008	B
rudy hobbs	Stub
rafael anchia	C
new york state democratic committee	C
tony capizzi	Start
james cowgill	Stub
kevin foy	C
debbie blackburn	C
marc feinstein	Stub
chris wallace	C
nicole galloway	C
schedule for the 2008 democratic national convention	B
george darany	Stub
dan blocker	C
jack cera	Stub
peggy pierce	Stub
milly bernard	Start
thomas taggart	Start
louis dipalma	Start
sergio torres torres	Stub
jack thomas brinkley	Stub
dan muhlbauer	Start
jeremiah clemens	Start
mark danish	Start
george mcgovern	FA
wall doxey	Start
lane bray	Stub
carroll knicely	Start
demion clinco	Start
the morals of chess	C
rebecca latimer felton	C
carole crist	Start
william cabell rives	C
john william meece	Stub
levi underwood	Start
harry stowers	Stub
bedford brown	Start
rory ellinger	C
bob etheridge	C
lawrence gates	Stub
walter mondale	GA
democratic party presidential primaries, 1972	C
paul dugan	Stub
sarah vogel	Start
thomas carlin	Start
congressional progressive caucus	C
les aucoin	GA
melvin baldwin	Start
ira allen eastman	Start
alexander davis	Start
david coss	Start
timothy black	C
dennis archer	Start
dale alford	C
dina neal	Start
david kizzia	Stub
annabelle jaramillo	Start
michigan democratic primary, 2008	GA
frank hinman waskey	Stub
jonathan bing	Start
samuel lightfoot flournoy	GA
jonathan windy boy	Start
juan figueroa	C
donald hayworth	Start
donald cresitello	Start
billy beasley	Stub
ed arnold	Stub
mary kay papen	Stub
vince demuzio	C
linn boyd	Start
john wilkins whitfield	Start
emily cain	C
hansen clarke	C
bob brady	C
jessica ehrlich	C
arlene holt baker	C
marie strinden	Stub
katie hall	Start
lunch pail democrat	C
matthew beebe	Stub
willis allen	Start
felix grundy	Start
george washington olvany	Stub
james budd	C
reuven carlyle	C
sheryl crow	B
rosalie silber abrams	Stub
annette baker fox	GA
mario palumbo	Start
deborah reynolds	Stub
john dapcevich	Start
levi woodbury	C
young democrats of america	Start
tom allon	Start
list of democratic national conventions	B
jerry brady	Start
roger lawson gamble	Stub
josh earnest	C
1852 democratic national convention	C
janine boyd	Stub
chris tuck	Stub
edward acevedo	C
battleground texas	GA
art goodtimes	Stub
evelyn blackmon	C
denise andrews	Start
pat ahumada	Stub
shemia fagan	Start
upton scott heath	Stub
john fairfield	Start
pat gagliardi	Stub
david maney currin	Start
tom conroy	C
james kealoha	C
bernie hunhoff	C
zachariah glenn fulmer	Stub
john calhoun brown	Start
barnes compton	Start
john wesley davis	Start
lowe finney	Start
joseph poindexter	C
patsy knight	Stub
1844 democratic national convention	B
dona irwin	Start
fort gadsden	C
progressive democrats of america	C
jason altmire	C
dick batchelor	C
wally barron	Start
sarah copeland-hanzas	Stub
david miramant	Stub
nebraska democratic caucuses, 2008	C
brian baird	C
joe aresimowicz	Start
nancy rodriguez	Stub
kathy castor	C
gail kulick jackson	Start
jim trujillo	Start
pete geren	C
walker brooke	Start
barbara becnel	Start
doyle conner	Start
israel pickens	Start
marsha cheeks	Stub
del bausch	Stub
nickey browning	Stub
reggie fullwood	C
bonnie cullison	C
sherrard clemens	Start
leslie petersen	Stub
valerie foushee	Stub
linda bolon	Start
joe paskvan	Start
joe gardner	Stub
sylvester pennoyer	GA
benjamin cruz	C
nia gill	C
temple dickson	C
ben erdreich	Start
henry drum	Stub
jesse beams	C
hattie derr	Stub
bagatelles and satires	Start
robert pryor henry	Stub
miriam hopkins	C
ron guggisberg	Stub
wes watkins	C
candy ruff	Stub
phil mendelson	GA
joseph hemphill	Start
billie sol estes	C
sharon ambrose	Stub
robert giese	Stub
john breathitt	GA
hosea washington parker	Start
john adler	B
alaska democratic party	C
clayton hee	Start
alan cohn	Start
caleb ayer	Stub
brandon dillon	Start
vincent orange	GA
lies and the lying liars who tell them	C
dennis damon	Start
gerald and sheila broflovski	C
bill avery	Stub
joseph lane	GA
lansing stout	C
hillary clinton presidential primary campaign, 2008	B
john morgan bright	Start
josiah begole	Start
jane mecom	Start
mary gaskill	Start
doris kelley	Stub
darrel aubertine	GA
thomas davee	Stub
joseph begich	Stub
jerry frangas	C
braswell deen	Stub
charles bronson	C
burrell ellis	C
marjoie kilkelly	Stub
jack batton	GA
jonathan brostoff	Start
adrian arnold	Stub
david cassidy	GA
glenn griswold	Stub
avery garrett	Stub
dave kopel	Start
lorraine hine	Stub
pete aguilar	GA
marcos devers	C
florida democratic party	C
leroy garcia	Stub
emily virgin	Stub
terri austin	Stub
deb ruggiero	Start
john viola	Start
daniel maynadier henry	Stub
sal pace	C
david crews	C
gary hirshberg	Start
ross diercks	Stub
1992 democratic national convention	C
richard lerblance	Stub
max heller	C
erasmus lee gardenhire	Stub
estes kefauver	C
demetrius douglas	Stub
wellington webb	Start
eduardo bhatia	C
mike kreidler	C
ron de lugo	Start
iowa democratic party	C
bob graham presidential campaign, 2004	C
timothy dougherty	Start
frank kowalski	Start
democratic party presidential primaries, 1968	GA
howard vollum	Start
walls mccrary	Start
jack casey	Start
william sorrell	C
bernadette sanchez	Stub
billy lee evans	Start
kay hagan	C
inez knight allen	C
teno roncalio	Start
united states presidential election in new hampshire, 1992	C
ralph norman bauer	Start
richard holbrooke	GA
mary jane garcia	C
edward livingston	C
carl danberg	Start
june atkinson	C
ben pangelinan	Start
john kissig cowen	Start
miles crowley	Stub
evan dobelle	C
wilhelmina rolark	Start
samuel dibble	C
carl elliott	C
heather podesta	Start
ellen rosenblum	C
patrick henry	B
kelly bryant	Start
james langevin	C
esther clenott	Stub
vermont democratic party	C
utah democratic party	C
mary cathcart	Stub
ty cullen	Start
duncan clinch heyward	Start
john de jongh	C
amos coggswell	Stub
linda mcculloch	Start
swati dandekar	C
richard cordray	GA
james garner	GA
tom cullerton	GA
philip lader	C
iowa democratic caucuses, 2004	C
stacey evans	Stub
john hickenlooper	C
david catchings dickson	Start
togiola tulafono	C
chandra dillard	Stub
overton brooks	B
john pino	Start
thomas gallen	Start
luis santaliz capestany	Stub
robert jacquard	C
florida election recount	FA
paula dow	C
utah democratic primary, 2008	Start
sala burton	Start
howard dean presidential campaign, 2004	B
gerry connolly	GA
barry alderette	Stub
allen kukovich	Start
jimmie lou fisher	C
eugene houdry	Start
florence jaffray harriman	GA
peter defazio	C
jim costa	C
jonah sanford	Start
roberto gonzales	C
maria cardona	C
barbara ballard	Start
hannah atkins	C
rich bradley	Start
waco siege	B
shepherd leffler	Start
jennifer benson	Stub
george washington bridges	C
george gibbs dibrell	C
audie bock	C
alexander smyth	Start
greg fischer	C
phil carruthers	Start
thomas hinds	Start
patricia schroeder	C
sam caldwell	C
fran ulmer	C
ezra dean	Start
benjamin champneys	Start
laurie jinkins	Start
first inauguration of andrew jackson	GA
val demings	C
dee morikawa	Start
joseph almeida	Start
su ryden	C
libertarian democrat	C
ralph cappy	Stub
lawton chiles	B
kelvin butler	Start
lincoln loy mccandless	Start
alexander miller harvey	Start
conservative democrat	B
charles arthur anderson	Start
lincoln dixon	Start
jack hatch	Start
william jackson creel	Start
tim bishop	GA
william ruffin cox	C
1920 democratic national convention	C
joseph oliva huot	Start
seth berry	Start
brad woodhouse	Start
charles brunner	Stub
kim hendren	C
deborah cherry	Start
edward george hoffman	Stub
gippy graham	Start
carolyn laine	Start
tim greimel	Stub
benjamin burr	Stub
elizabeth edwards	GA
mary neuhauser	Stub
erin oban	Stub
democratic party presidential primaries, 1952	B
evandro carvalho	Stub
barbara staggs	C
sandra blanton	Start
joe jett	Stub
robert burns smith	Start
jessica vega pederson	Start
robert craven	Start
gilbert hitchcock	C
dickey lee hullinghorst	C
james joseph brady	Stub
wayne dowdy	Start
rafael cox alomar	C
john preston buchanan	Start
abe fortas	B
luis vega ramos	Start
jim burn	Start
jonathan cilley	Start
dave bruderly	Stub
tom steed	C
greg hecht	Start
lyman hoffman	Start
john watson barr	Start
jean hall lloyd-jones	Stub
christopher augustine buckley	Start
mary beth cahill	Start
list of democratic nominees for governor of illinois	Start
james sloan kuykendall	GA
democratic party presidential primaries, 2012	GA
william stanbery	Start
edgar may	Start
sim gill	Start
rick moye	Start
nora walker	C
michael padilla	C
milton berkes	Stub
waldo colburn	C
abraham bockee	Start
marcus oshiro	C
denny bixler	Stub
bob crowell	Stub
hugo black	FA
william francis bailey	Stub
dana childs	Start
mia gregerson	Start
john branch	Start
ron cyrus	Start
jerry apodaca	Start
evan bayh	B
russell ruderman	Stub
oklahoma democratic party	C
victor anfuso	Start
sally bolster	Stub
jeff steinborn	Stub
raul bocanegra	Stub
patrick hamill	Stub
joe lieberman presidential campaign, 2004	B
john ford house	Start
white league	C
keith skelton	Start
keith kreiman	Start
david bly	Start
austin letheridge bender	Start
edward abend	Start
tracy potter	Start
jay kerttula	Start
michael sprigg	Stub
grace diaz	Stub
craven street: ben franklin in london	Stub
cory atkins	Start
the nation	C
joseph vogel	Start
forward together pac	Stub
susan bucher	C
anthony pollina	C
john benton sterigere	Start
anti-federalism	C
la fayette grover	Start
westmoreland davis	Start
dan bowling	Stub
marc keahey	Stub
jeff bingaman	C
committee for cultural freedom	B
bourbon democrat	C
dean alfange	C
michael bloomberg	B
artur davis	GA
josh lyman	B
donald knapp	Stub
anita bonds	C
herb conaway	C
tom berry	Start
rollin howell	Stub
mississippi democratic primary, 2008	Start
joel judd	C
ed perlmutter	C
ralph anthony howard	Stub
isabella cannon	C
margaret anderson kelliher	C
tommy burnett	C
denver david hargis	Start
richard cates	Start
nathan gaither	Stub
ben westlund	C
mike mclachlan	Start
henry bell gilkeson	GA
john hoeven	C
peter schwartzkopf	Stub
jacob krebs	Stub
stephanie flowers	Start
sherry appleton	Stub
walter maddox	C
john little mcclellan	C
jack mcdowall	Start
john kerr hendrick	Start
harold hughes	C
chris gorsek	Start
fonda hawthorne	Stub
nicholas kafoglis	Stub
daniel elliott huger	Start
paula hawks	Start
wesley lloyd	Stub
houston fields	Stub
gregorio sablan	C
andrew beirne	Start
kaniela ing	C
reece caudle	Stub
advice to a friend on choosing a mistress	C
marion greene	Start
alonzo garcelon	Start
john hamlin folger	Start
jennie cave	Stub
viola baskerville	Start
alejandro almeida	Start
1980 democratic national convention	C
peter camiel	Stub
suzanne chun oakland	Stub
james barker edmonds	Start
carlo basile	Stub
rachel maddow	GA
walter boasso	C
rick krueger	Stub
benjamin joseph franklin	Start
charlie smith dannelly	Stub
john kenneth galbraith	B
irv anderson	Start
linda berglin	Start
andrew jackson donelson	B
martha fuller clark	Start
henry burns	GA
thomas king carroll	Start
tobias read	Start
sue errington	Stub
james brolin	C
christopher columbus andrews	C
ken esquibel	Stub
tracy velazquez	Start
malama solomon	Start
keith ellison	C
mark kruzan	Stub
jim bacchus	Start
james graham fair	C
mitch irwin	Stub
steven vanroekel	Start
pamela richards samuel	Start
richard hines	Stub
charles graddick	Start
jesse jackson presidential campaign, 1988	C
kelly doran	Start
linda ronstadt	GA
greg lind	Stub
why mommy is a democrat	Start
howell heflin	C
hanna gallo	C
morris hood iii	Stub
taddy aycock	C
keith leftwich	Start
wayne deangelo	C
wayne goodwin	C
john bass	Stub
nevada democratic caucuses, 2008	GA
sidney breese	B
inez barron	Start
willie cochran	Stub
lafayette emmett	Stub
joseph lafayette rawlins	Start
kate gale	Start
janice pauls	Stub
thomas rodella	Start
harvey butler fergusson	Start
richard holman	Stub
tony eckstein	Start
vernon cook	Start
samuel medary	Start
mike fahey	Start
joyce beatty	C
clem mcspadden	Start
democrats abroad primary, 2008	C
jehu baker	Start
bob ziegler	Stub
francis dolan collins	Stub
scott parsley	Start
talking right	Start
beth bye	C
joseph maestas	Start
sam hobbs	Start
augustus barrows	Start
christina hale	Stub
jennifer brunner	GA
elizabeth steiner hayward	Stub
penny williams	C
kathy angerer	C
george washington glick	Start
rich olive	Start
catherine cool rumsey	Stub
jere baxter	Start
will brownsberger	Start
christian burridge	Start
rae lynn job	Stub
robert dvorsky	Start
christie brinkley	GA
andrea dalessandro	Start
simone bell	Start
eber phelps	Stub
silas bryan	Start
gerald heaney	FA
george ernest foulkes	Start
campbell polson berry	Stub
efren carrillo	C
thomas francis gilroy	Start
cecil heftel	Start
bruce sundlun	GA
bill heckroth	Stub
rollie heath	C
john james jones	Stub
joe bertram frantz	Start
clint stennett	Start
claire underwood	GA
earl faircloth	Stub
lois capps	C
art feltman	Stub
david bernier	C
ruby ridge	B
mary burke	C
lynn hemingway	Start
dennis murphree	Start
lon johnson	C
scott nishimoto	Start
mary helen garcia	C
caleb cushing	C
jim elliott	Stub
hampton dellinger	Stub
eddie armstrong	Start
ely moore	Start
barnburners and hunkers	B
ann callis	C
mike tate	Start
karla drenner	Start
william george bruce	B
hugh roy cullen	C
andrew biemiller	C
albion parris	Start
washington democratic caucuses, 2004	Start
1976 democratic national convention	C
howard cannon	Start
richard bryan	Start
gloria stivic	Start
gary lapaille	Stub
alan dershowitz	C
ellsworth raymond bathrick	C
susy blake	Stub
ernest hollings	C
philip hart	GA
deborah kafoury	Stub
john mccrostie	Start
jared nunes	Start
edward eastman	C
joe joiner	Stub
winnie brinks	Stub
earlean collins	Start
archibald atkinson	Start
battle of new orleans	FA
sam houston	FA
rita heard days	Stub
bernie sanders	GA
eve franklin	Stub
alec baldwin	B
dick kink	Stub
george groesback	Stub
iowa democratic caucuses, 1976	Start
george guerieri	Stub
donald berwick	GA
johnny behan	B
edgar howard	Start
frank chermak	Stub
evelyn chesky	Stub
dixon hall lewis	Start
john alexander ahl	Stub
pamela hatch	Stub
harry young cochran	Stub
vi daley	C
george blackmore guild	Stub
franklin institute	C
merle boucher	Start
elizabeth hawley gasque	Start
rosemary corbin	Start
horace greeley	FA
maggie hassan	GA
james henry mays	Stub
james henderson blount	Start
bruce bawer	B
steve bergquist	Stub
joe hubbard	Start
george augustus la dow	Start
george tankard garrison	Start
erastus brooks	Start
george bandy	Stub
andrei cherny	C
rufus king jordan	Stub
heather higginbottom	Start
theodore berlin	Stub
william worth dickerson	Stub
james dahlman	C
david aceveda	C
manchester boddy	C
woodie salmon	Start
cornelius desmond	Start
sandra bolden cunningham	C
michael gronstal	Start
joe polisena	Start
amos tuck	C
henry watkins allen	C
john baylor	C
ralph metcalf	C
peter garland glover	Stub
pryor lea	C
tom anzelc	Start
george sydney hawkins	Start
mark cusack	Start
ralph moses paiewonsky	Start
marcel black	Stub
dorothy barnes pelote	Start
populist caucus	Start
jillian banfield	C
debbie holmes	Stub
rick glazier	Stub
kim wallin	Start
andrew horatio reeder	Start
paul jabour	Start
roman gribbs	C
elizabeth phelan	Stub
john charles edwards	Start
fred joseph nichol	Start
paulette beaudoin	Stub
wayne angevine	Stub
oswald west	C
herschel vespasian johnson	C
anthony barill	Stub
alvin greene	GA
rodney alexander	C
andrew boone	Stub
timothy kraft	C
statewide opinion polling for the super tuesday democratic party presidential primaries, 2008	B
marshall arnold	Stub
elmer thomas	C
mississippi democratic party	C
mark singel	C
george kremer	Stub
james norick	Stub
alfred cuthbert	Start
harriet drummond	Stub
angie paccione	GA
berry forte	Stub
ronnie flippo	Stub
mayor quimby	GA
libby mitchell	Start
thomas alan goldsborough	Start
matt claman	Stub
actblue	Start
peg mullen	C
joseph bryan thompson	Start
charles lafayette bartlett	Start
rocky anderson	FA
vincent gregory	Start
mary brennan	Stub
mckinley bailey	Start
gil cedillo	C
30 something working group	Start
roberta collins	C
james cargas	Start
sally shelton-colby	C
pedro pierluisi	C
heather bishoff	Start
gale brewer	C
josiah bartlet	B
bob henriquez	C
john catlin	Start
science leadership academy	C
james brett	Start
donna pence	Start
ben cayetano	C
elmer mccollum	FA
nathan baskerville	Stub
clyde tingley	Start
greg stanton	C
waco tribune-herald	Start
john hailey	Start
donna nesselbush	Start
brad avakian	GA
sam gejdenson	Start
john mccracken robinson	Start
joel turrill	Stub
massachusetts democratic party	C
ken hansen	Stub
lynn bromley	Stub
waggoner carr	C
billy broomfield	Stub
augustus bradford	Start
richard barringer	Stub
andrew carn	Stub
abraham beame	C
john barton payne	Start
independent democrat	Start
mele carroll	Start
charles roberts ingersoll	Start
frank ciccone	Start
david jackson bailey	Start
democratic study group	Stub
william miranda torres	Stub
david agry	Start
dick gephardt	GA
mark kelly	GA
rue mcclanahan	GA
john tillman lamkin	Stub
skipper bowles	Start
richard nelson mason	Start
saqib ali	C
orval faubus	C
clifford allen	C
guy carbone	Stub
asa grover	Stub
michigan democratic party	Start
jeannie mcdaniel	Start
joel barlow sutherland	Start
joseph fidel	Stub
hans borchsenius	Start
marc basnight	Start
joshua hall	Stub
peter myndert dox	Stub
milledge luke bonham	C
steve adubato	C
robert todd lytle	Start
alexander billmeyer	Stub
joseph brown heiskell	Start
isaac goodnight	Start
tom hawk	Start
carville benson	Start
carol voisin	Start
frank comerford walker	Start
don ryan	Stub
zbigniew brzezinski	B
mack cleveland	Start
john melcher	Start
james mcnair baker	Start
david cruz thayne	C
john kromko	Stub
gerald pease	Stub
rocky adkins	Stub
hugo black iii	Start
henry bedinger	Start
bob alligood	Stub
jefferson davis brodhead	Stub
ana nisi goyco	Stub
armistead burt	Start
gina raimondo	C
carl gutierrez	C
michelle dunphy	Stub
adlai stevenson i	C
darnell earley	GA
margarethe cammermeyer	Start
adam baldwin	C
larry darby	C
john catron	C
scotty baesler	Start
martin maginnis	C
danielle conrad	Start
cary kennedy	Start
roger ballenger	Stub
perry belmont	C
brock adams	C
ned lamont	C
anthony colaizzo	Stub
joseph showalter smith	Start
journal record building	C
ron buxton	Stub
archibald cox	FA
doug hoffer	Start
clif moore	Stub
ellen corbett	C
david crowley	Start
paul bookout	Start
amber boykins	Stub
rebecca rios	Start
linda chapa lavia	Start
cyrus cline	Stub
elmer floyd	Stub
gail finney	Start
augustus hall	Start
joseph emile harley	Start
william thomas hamilton	Start
julie menghini	Start
david cicilline	C
joyce dickerson	Start
doreen howard	Start
frank hereford	Start
james paull	Start
dudley farlin	Stub
hawaii democratic caucuses, 2008	Start
city of blinding lights	FA
gene austin	C
nathan clifford	B
joseph duffey	Start
christine gregoire	GA
patricia blagojevich	Start
michael mauro	Stub
octaviano ambrosio larrazolo	C
darren jernigan	Stub
rebecca vigil-giron	C
deborah read	Start
robert bellomini	Stub
marti anderson	Start
carmine desapio	C
james joseph hines	C
leatrice morin	Stub
robert rufus bridgers	Stub
nora campos	Start
kathleen sebelius	GA
adrian fenty	B
mary brandenburg	C
oscar lapham	Start
tony bennett	GA
jacob bodden	Start
polly rosenbaum	C
terry john care	Stub
stefanie mach	Stub
alison lundergan grimes	C
timothy mcveigh	GA
jack dootson	Stub
daisy lawler	C
jim dabakis	C
mike cooney	GA
cal cunningham	C
joseph brannigan	Start
john wesley ross	GA
james butler hare	Start
roy romer	C
oscar callaway	Start
isaac asimov	B
hy kloc	Start
ethan berkowitz	C
kitty piercy	C
arkansas democratic primary, 2008	Start
arianna huffington	B
george bragg fielder	Start
talmadge branch	Start
new direction for america	Stub
george mcgovern presidential campaign, 1972	B
bartlett tripp	C
bo callaway	C
1924 democratic national convention	C
jane isbell	C
augustus schell	Start
claude pepper	C
winfield scott hammond	Start
david beasley	Start
benny bonanno	Stub
zolton ferency	Start
ted wheeler	C
pennsylvania democratic party	C
carolyn colvin	Start
jonathan hazard	Stub
joseph brogan	Stub
2004 democratic national convention	C
louis ruiz	Stub
clay ford	Start
south dakota democratic party	Stub
john elton coon	Start
marge simpson	FA
john albert johnson	C
lois deberry	C
henry cisneros	B
byron mallott	C
1956 democratic national convention	B
lane larson	Stub
lorenz becker	Stub
alan bible	C
don cazayoux	C
dale bumpers	C
maine democratic party	C
hugh floyd	Stub
2000 democratic national convention	C
dean smith	GA
gordon woodbury	Start
james buchanan	FA
jim folsom	C
working families party	B
bob deig	Stub
phil griego	Stub
william jennings bryan presidential campaign, 1896	FA
levin gale	Stub
richard lindsey	Stub
linda collins-smith	Stub
cowboy pink williams	C
michael benedetto	Start
1988 democratic national convention	C
nick koback	B
phil diserio	Stub
jim whitty	Stub
matt heinz	Start
anthony dimond	Start
dolph briscoe	C
nevada democratic party	C
hildy kuryk	Start
lincoln chafee presidential campaign, 2016	C
cliff larsen	Stub
leonard maison	Stub
king woolsey	C
beth kerttula	Start
bobby darin	C
james woods	GA
william grose	C
angela romero	Start
phil giaquinta	Stub
jeremy nordquist	C
scott lee cohen	C
bill press	C
sherman page	Stub
thomas wingfield grimes	Stub
richard graham frost	Stub
helen miller	Start
lucy flores	C
dennis horlander	Start
burwell bassett	Start
jon jennings	Start
boise kimber	C
vincent davis	Stub
sue hecht	C
law school democrats of america	B
john girgenti	Start
harriet grant	Stub
tom bevill	Start
john laporte	Stub
mary hodge	Start
jill billings	Start
john eng	Stub
lisa otondo	Stub
mike kernell	Start
bill heller	C
knute hill	Start
alabama democratic party	Start
merrill mcpeak	B
david bobzien	Stub
john binienda	Stub
margaret long	Stub
danny coulson	Start
james indus farley	Stub
ed potillo	Start
alexander graves	Stub
betsy hodges	Start
alexander boteler	Start
thomas holliday hicks	C
bill bradley presidential campaign, 2000	Start
tom delonge	FA
midwest values pac	Start
clarena brockie	Stub
tom buck	Stub
american philosophical society	C
jesus borja	C
james stephens brown	Stub
francisco ada	GA
mona jean russell	Start
jim lee howell	Start
nathan dean	Start
ron wyden	GA
micajah thomas hawkins	Start
emanuel cleaver	C
john sapien	Stub
dennis kucinich presidential campaign, 2004	C
atari democrat	Start
kate knuth	Start
elmer hyppa	Stub
matt damon	GA
shirley franklin	C
adam clarke snydor	Start
william cabell bruce	Start
mika brzezinski	C
robert frederick collins	Start
gwen howard	C
michela alioto-pier	C
clement comer clay	Start
geoffrey gratwick	Start
ellen cohen	Start
margaret dennison	Stub
jon hoadley	C
john bigler	GA
charles mcvean	Stub
furnifold mclendel simmons	Start
jared polis	GA
kathleen sgambati	Stub
tami green	Stub
dan edward garvey	Start
ohio democratic party	B
john peter richardson ii	Start
mike panetta	Start
benjamin tappan	Start
jim lendall	Stub
1848 democratic national convention	Start
reuben knoblauch	Stub
bill bradley	FA
john arthur smith	Stub
sherra lane	Stub
lela alston	C
thomas abernethy	Start
william henry fleming	Start
dave pine	GA
bill feuerborn	Stub
brien mcmahon	C
oklahoma city national memorial	GA
cave johnson	Start
india edwards	C
bob hattaway	Stub
mary teresa norton	Start
taylor barras	Start
kelvin atkinson	Start
brian beedenbender	Start
john currey	Start
john lee carroll	C
jim kyle	Start
fredrick love	Start
charles hillman brough	Start
frank joseph guarini	Start
mufi hannemann	C
josiah franklin	Start
john hieftje	Start
john scott medal	Start
monte hodges	Stub
aime forand	Start
jean ankeney	Stub
randall balmer	Start
lauch faircloth	Start
byron georgiou	C
william raworth cooper	Stub
john appleton	GA
kate brown	C
weems oliver baskin, iii	Stub
brent edison	Start
tammany hall	FA
mary kay becker	Start
bobby badon	Start
1948 democratic national convention	Start
kate witek	Start
mulford winsor	C
herb bergson	Start
phil keisling	C
rembert dennis	Stub
polly bukta	Stub
missouri democratic party	B
ferdinand schureman schenck	Stub
terry bellamy	Start
2000 democratic national convention protest activity	C
kathy swanson	Stub
lorraine inouye	Start
drew hansen	Start
roger breske	Stub
richard hammel	Start
bob bacon	Start
dudley doolittle	Start
keith fitzgerald	Start
don beyer	GA
john critcher	Start
richard irvine manning i	Start
linda dean campbell	Start
bruce morris	Start
angela bryant	Stub
peter bowman	Stub
norby chabert	C
jamar adcock	C
joseph curtatone	Start
kent conrad	C
john young brown iii	Stub
prentice cooper	GA
james buskey	Stub
joycelyn elders	C
tennessee democratic primary, 2008	Stub
victoria kornfield	Stub
jeremy kalin	Start
alvin holmes	Stub
william parker caldwell	Start
richard keese	Stub
gibson atherton	Start
kansas democratic caucuses, 2008	C
paul ranous greever	Start
fred nolting	Stub
charles erskine scott wood	C
casey schreiner	Stub
stuart ballantine medal	Start
clinton clauson	Start
abram comingo	Stub
valerie longhurst	Stub
lamar jeffers	Stub
nancy riley	C
jeannie darneille	Stub
gary merrill	C
frank ballance	Start
clarke lewis	Stub
helene keeley	Start
thomas volgy	Stub
wilford woodruff	GA
hubert fisher	C
les aspin	GA
jean amatucci	Start
howard carwile	Start
benjamin baker moeur	Start
lenn hannon	Stub
walter meheula heen	Start
maryellen goodwin	C
oklahoma city bombing conspiracy theories	C
rick kolowski	Start
conner eldridge	GA
1868 democratic national convention	C
gray davis	FA
barbara merrill	C
alfre woodard	FA
gracie pfost	C
tom brower	Start
capri cafaro	C
ted trimpa	C
stan matsunaka	Start
kristin hedger	Stub
progressive policy institute	Stub
curt anderson	GA
harry dudkin	Start
albert hale	C
hattie caraway	C
charles edward bennett	C
lynn decoite	Start
josephus daniels	C
charles august sulzer	Start
russell mcwhortor cunningham	Stub
gitmo on the platte	Stub
the speech of polly baker	C
bob mollohan	Start
martin frederick ansel	Start
shelton leake	Start
sam kito iii	Start
gregg amore	Stub
warren mosler	C
bibb graves	C
lemuel amerman	Start
bobby bright	C
deb gardner	Stub
2012 democratic national convention	GA
helen davis	Stub
tarryl clark	C
martin durkan	Stub
arline friscia	Start
mary ann shallcross smith	Stub
delia garcia	Stub
james carville	C
new jersey democratic state committee	Start
franklin pierce	FA
david ellicott evans	Start
william patterson borland	Start
frederick perry stanton	Start
jocelyn benson	C
raymond eugene plummer	Start
ray blanton	B
mark grebner	C
aaron fussell	Stub
daniel issa	Start
george barnes grigsby	Start
mary manross	Start
kim holland	Start
david baria	Start
kevin easley	C
kika de la garza	Start
john reeves jones daniel	Start
south carolina democratic party	Start
richard lee metcalfe	Stub
marcos irizarry	Stub
isaac toucey	Start
marjorie clapprood	Start
virginia democratic primary, 2008	C
sampson jackson	Stub
julius hotchkiss	Start
adolph biermann	Start
tom stout	Start
carlie boland	Stub
sam lumpkin	Start
joseph hugh allen	C
david lemoine	Stub
garnett adrain	Start
josiah gardner abbott	Start
thlocklo tustenuggee	Start
kenneth dunkin	C
charles anding	Start
gordon fox	C
dan clodfelter	Start
john hardy steele	Start
ophelia ford	Start
robert washington fyan	Start
jabez young jackson	Stub
arizona democratic primary, 2004	C
yancey mcgill	Start
william henry denson	Stub
democratic party of new mexico	C
brady paxton	Start
ernest chavez	C
pat garrett	B
utne reader	Start
colleen hanabusa	GA
minnesota young dfl	Start
frank lombardo	Start
einar hoidale	Start
lemuel sawyer	Start
john price wetherill medal	Start
horatio seymour	C
alec brook-krasny	Start
josiah dent	Start
horace chilton	Stub
bill birchfield	C
mike gravel presidential campaign, 2008	B
lane carson	Start
jane eberle	Stub
jordan brandman	C
art kimball	Stub
gary hart	GA
maxine horner	Start
tom daschle	GA
sol bloom	C
bruce babbitt	C
james capehart	Start
shirley hooper	Stub
burke riley	Start
julia boseman	Start
rawghlie clement stanford	C
katherine clark	GA
joe dini	Start
john grisham	B
john daniel clardy	C
mike dmitrich	Stub
john sparkman	GA
robert butkin	Start
william jackson humphreys	Start
peter cammarano	C
joe bolkcom	Start
bradley walker	C
dean depiero	Stub
elizabeth bobo	Start
cabinet counties	Start
sally pederson	Stub
jeremiah burrell	Stub
ralph derose	Stub
robert wyche davis	Start
jim baca	Start
arizona democratic party	C
mercy otis warren	GA
wendell gilliard	C
sheila arnold	Stub
robert sivertson	Stub
democratic party of hawaii	C
will marshall	Stub
john nance garner	C
paul hodes	C
hannibal lafayette godwin	Start
monte geralds	Stub
roberto prats	Start
andy billig	C
willie nelson	FA
angela monson	C
andrew ewing	Start
nicole poore	Stub
sharon har	Start
mike novick	B
george hyde fallon	Start
dan grossman	Start
edward bishop dudley	C
daniel woodson	Start
george madison adams	Start
joseph clemmons	C
barbara favola	Start
nancy dembowski	Start
stephanie cutter	C
nellie tayloe ross	C
anna johnson gates	Start
doug gansler	GA
gwen graham	C
anthony andrezeski	Stub
abel corbin	Stub
terese berceau	Start
izetta jewel	GA
dan pabon	C
james henry hammond	C
dudley selden	Start
christopher blazejewski	Start
jerry costello ii	Stub
united states bill of rights	GA
henry white beeson	Stub
freemen on the land	C
gary gensler	GA
anthony cavalcante	Start
gomer griffith smith	Start
tammy baldwin	C
henry cuellar	C
tiffany lawrence	Stub
elmer holt	Start
ruth meiers	Stub
charles creighton carlin	Start
leighton cooney	Start
chris rothfuss	Start
clinton lesueur	Start
reubin askew	C
ready pac	C
george soros	B
david kellogg cartter	Start
richard taylor jacob	Start
joe kroeber	Stub
ann mah	Stub
robert condon	Start
david frederickson	Start
1860 democratic national conventions	C
harry streett baldwin	Stub
james nicholas kehoe	Stub
frank boyle	Stub
waco, texas	B
tick segerblom	Start
mike beebe	C
cherie buckner-webb	Start
jean farmer-butterfield	Stub
charles john biddle	Start
william allain	C
robert bergland	Start
frank holleman	Start
edward garmatz	Start
john dewitt clinton atkins	Start
taylor webster	Start
kevin furey	Stub
alan blinken	Stub
scott mcclure	Stub
william holcombe	Stub
kathy hogan	Stub
sanford kirkpatrick	Start
forrest claypool	C
greg jergeson	Stub
reid bennett	Stub
scott ferris	Start
john lafayette camp	Start
gary ackerman	C
stephen allen	Start
archie clement	C
jim berryman	Start
joan wagnon	Start
hamilton holt	Start
grace kelley	Stub
robert gibbs	GA
charles gordon edwards	Start
stephen moriarty	Stub
artists for obama	Start
jim chrest	Stub
mark bernstein	Start
give me liberty, or give me death!	C
kenyan mcduffie	GA
john kyle	Start
alisa cooper	Stub
jack eckerd	C
woodrow wilson	FA
norman berson	Stub
democratic party presidential primaries, 2008	B
april fairfield	Stub
barbara boxer	B
lucien bonaparte chase	Start
dave loebsack	C
brendan crighton	Stub
mcdowell lee	Stub
spencer darwin pettis	C
katherine harris	B
toby ziegler	B
andy eisen	Stub
richard hawes	GA
jane watson stetson	Start
rupert phillips	Start
isaac vanderbeck fowler	Start
william badger	Start
hillary clinton presidential campaign, 2016	GA
robin abbott	Start
frank ivancie	C
sherry gay-dagnogo	Start
bruce wheeler	Start
willis alston	Start
marion christopher barry	GA
dan adler	C
william mccomas	Start
willye dennis	C
larry marek	Stub
eugene atkinson	Start
william delgado	Start
harry jacob lemley	Start
al smith	FA
jeremiah wright controversy	B
jeff greer	Start
kay barnes	Start
teodoro moscoso	C
chris beutler	Start
david ulibarri	Stub
ron barber	C
john edwards presidential campaign, 2004	C
kevin boyce	GA
harley bozeman	C
charles taylor manatt	C
texas democratic party	C
bobby dubose	Start
joseph tropila	Stub
1896 democratic national convention	C
james ronald chalmers	C
mark litchman	Stub
franklin landers	Start
richard iaquinta	Start
hans crocker	Start
william francis gibbs	C
burke harr	Start
michael szwarc	Start
milton robert carr	Start
ron erickson	Stub
simon cameron	C
kent eken	Start
peter vivian daniel	C
leonard jarvis	Start
debbe leftwich	Start
list of presidents of the popular democratic party of puerto rico	Stub
terry mcauliffe	GA
kesha ram	Start
ken donnelly	Stub
marie steichen	Stub
jesse franklin cleveland	Stub
carlos cisneros	Stub
hugh quincy alexander	Start
amanda merrill	Stub
james cantwell	C
huma abedin	GA
democratic party presidential candidates, 2008	FA
alberto coutinho	C
scott holcomb	C
justin marcum	Stub
thomas fielder bowie	Start
wilson bell	Stub
kansas democratic party	C
arthur fenner	C
kenneth hodges	Stub
regina barrow	C
democratic party presidential primaries	C
augustine lonergan	Stub
vivian flowers	Start
dan barton	Start
sheldon whitehouse	GA
alan cranston	C
virginia court	Stub
clarence cannon	C
james eastland	C
edmund muskie	GA
henry graybill lamar	Stub
robert citron	C
lydia hernandez	Stub
michael dembrow	Start
philip munger	B
alfredo duran	C
list of barack obama presidential campaign staff members, 2008	B
alfred madison barbour	C
mama lucy gang	FA
john cranley	C
guillaume de ramel	C
walter hampden overton	Start
jackie clarkson	C
charles isenhart	Start
mississippi freedom democratic party	C
bert bandstra	Start
david boies	C
daphne campbell	Start
kim elton	C
kendall van dyk	Start
john hottinger	C
william denis brown iii	C
james kimbrough jones	Start
cal anderson	Start
peter hoagland	Start
anne dallas dudley	GA
mark warner	C
jane warren	Stub
britt cobb	Start
democratic party presidential primaries, 1992	B
donald defronzo	Stub
garrett davis	Start
dennis heck	C
marcella frevert	Stub
winder laird henry	Stub
george william crump	Start
larry balweg	Stub
mike jaros	Stub
eldon nygaard	Start
ana sol gutierrez	Start
paula aboud	Start
bill gwatney	Start
george washington donaghey	C
george crady	Start
amy rice	Stub
madeline cain	Stub
ken kelash	Start
eleazer wheelock ripley	C
charles tillinghast james	Start
democratic caucus of the united states house of representatives	Start
dave cheatham	Stub
thomas alley	Stub
elaine alquist	Start
bob bartlett	Start
tracy boe	Stub
peggy maxie	Stub
madeleine bordallo	C
culbert olson	C
william meade fishback	Start
virginia aveni	Stub
faoa aitofele sunia	C
karl kassel	Start
temo callahan	Start
history of the united states democratic party	B
lee cruce	C
roger dickinson	C
michele reinhart	Stub
fred phelps	GA
kim gillan	Start
roger rawson	Stub
wayne morse	GA
john chilton burch	Stub
justin alfond	C
ruth kagi	Stub
samuel smith harrison	Stub
curtis mcdaniel	Start
bruce braley	C
herbert harris	Start
elton trowbridge	Start
david crabiel	Stub
burr harrison	Start
sam coppersmith	Start
larry joe doherty	C
john mills allen	Start
fred baden	GA
jouett shouse	C
don betzold	Start
charles thomson rees wilson	Start
james dworak	Start
brainerd mission	Start
george cardenas	Start
george turman	Stub
joseph dicarlo	C
geraldine ferraro	FA
gove saulsbury	C
eugene mccarthy presidential campaign, 1968	GA
1835 democratic national convention	Start
eleanor mcgovern	Start
kathleen blanco	C
william west bond	Start
katharine byron	Start
bruce bryant	Stub
teresa benitez-thompson	Start
mark emblidge	C
douglas henry	C
alann johnson	Stub
bryon short	Start
patrick colwell	Stub
bull connor	C
brent budowsky	Start
virgil maxcy	C
matt delligatti	Start
william arnemann	Start
samuel byrns	Stub
john hartwell marable	Start
dubois family	C
al gore	FA
shirley ringo	C
yvonne kennedy	Stub
lea fite	Stub
jeanne atkins	C
harry lonsdale	C
ron lurie	Stub
james brochin	C
the best democracy money can buy	Stub
phil bredesen	GA
subby anzaldo	Stub
susi hamilton	Stub
bill gunter	Start
franklin pierce buyer	Start
peleg arnold	Start
linda longstreth	Start
kate waller barrett	GA
lonnie hosey	Stub
charles winfield	Stub
tomberry	Stub
nick clooney	C
robert desha	Start
tanya cook	Start
california democratic council	Start
josiah bailey	Start
thomas calter	Stub
berta gardner	Stub
george gray leiper	Start
gene ficken	Start
lloyd bentsen	GA
hugh joseph addonizio	C
lancelot phelps	Stub
dale hargens	Stub
hugh gillis	Stub
gerald francis clifford	C
michelle lujan grisham	C
michael ferro	Start
district of columbia democratic primary, 2004	Stub
david clarenbach	Start
asbury francis lever	C
roy takumi	C
maurine neuberger	Start
monroe sweetland	GA
carroll hollensworth	Stub
albert hofstede	Start
byron langley	Stub
joseph biancardi	Stub
robert harder	Stub
kiki curls	Start
michael dukakis	C
troy findley	C
robert harlan henry	Start
hulond humphries	C
alvin brown	C
dan besse	Start
lloyd fields	Start
gene burns	C
pam faris	Stub
lowell barron	Start
lou correa	Start
pinckney downie bowles	C
steve marchand	Start
christopher cabaldon	C
john lipton	Stub
matthew fielding locke	C
charles davis jameson	Start
pete gallego	C
thomas winfield	C
henry clay dean	C
betty jo charlton	Stub
jane goodall	FA
carlos french	Start
jesse lynch holman	C
thomas cunningham	Stub
augustine henry shepperd	Start
john goff ballentine	Start
johnny cash	C
morriss henry	Stub
chester burnham	Stub
luis arroyo chiques	Stub
theodore fields	Start
kitchen cabinet	B
george mcgill	Start
phil ferguson	Start
morgan welles brown	Start
harpers magazine	Stub
alvin wiederspahn	Start
samuel price carson	Start
sovereign citizen movement	B
mabel bassett	Stub
derek kilmer	C
elaine coderre	C
neil durrance	Start
edward fitzsimmons dunne	C
barbara flynn currie	Start
louisiana democratic primary, 2008	Start
jean hay bright	Start
william doan	Stub
jorge luis garcia	Stub
james patton anderson	C
greg boll	B
john lawrence manning	Start
maecenas eason benton	Start
delaware democratic party	C
united states presidential election, 1828	GA
donovan dela cruz	Start
joseph charles	Start
gary doty	Start
1996 democratic national convention	C
ward armstrong	Start
dan weinberg	Stub
phil angelides	GA
roeliff brinkerhoff	C
michael mcfaul	C
john willis ellis	Start
spencer black	Start
tom katus	Stub
tim firkins	Stub
chelsea clinton	GA
alan webber	C
ron herrell	Stub
louisiana democratic party	C
kim driscoll	C
terry beyer	Start
booth gardner	C
timothy jennings	Stub
monica dixon	Stub
jim margolis	C
webster hubbell	C
dean schrempp	C
ruth ann minner	GA
jim hodges	C
john droney	Stub
liz shuler	B
frank aguon	C
nels ackerson	B
rosemary clooney	C
robert william wells	Stub
mathew carey lea	C
jean berkey	Start
edward bassett	Start
bryce bennett	Start
stanley gerzofsky	Stub
thomas bouldin	Start
chauncey forward black	Start
missouri democratic primary, 2000	Stub
blanche calloway	B
seth wallace cobb	Start
george firestone	Start
claire levy	C
mary poling	Start
bo ackal	C
hunt commission	Start
john tucker campbell	Stub
john podesta	GA
kenneth michael trentadue	B
kristine lytton	Stub
raymond strother	C
1856 democratic national convention	B
max coll	C
nelson madore	Stub
david allen smalley	C
lowell norland	Stub
mike bonin	C
george damm	Start
frankie sue del papa	Start
richard engels	Stub
evelyn gandy	C
kimberly teehee	Start
ertharin cousin	C
paul begala	C
john hoynes	B
jocelyn burdick	Stub
krystal ball	C
chancy croft	C
united states virgin islands democratic territorial convention, 2008	Stub
jeffery cohelan	Start
jennifer granholm	GA
ken salazar	GA
donald mcginley	Start
will rogers	GA
harris mcdowell iii	C
emory speer	Start
democratic party presidential candidates, 2012	GA
andrew hosmer	Stub
craig coughlin	Start
guy edgar campbell	Start
senate democratic policy committee	Start
dario herrera	Start
tiffany alston	C
art hanes	Start
benjamin civiletti	C
jesse miller	Stub
emilien levesque	Stub
maggie carlton	Stub
benjamin franklin in popular culture	B
mike jopek	Stub
joseph webber jackson	Start
cher	GA
ellery albee hibbard	Start
joe andrew	Stub
clint curtis	C
ralph herseth	Start
dennis bonner	Start
george mason	FA
rich cowan	C
hans dunshee	Stub
larry balow	Start
william howard thompson	Start
shap smith	Start
phillip delaine	Stub
lee aaron bachler	Stub
real time with bill maher	C
george ariyoshi	Start
jonathan kreiss-tomkins	C
cathy cox	C
jere beasley	Start
louis crump	Stub
roxanne conlin	Start
pegeen hanrahan	Start
carolyn thompson taylor	C
stephen king	B
frank ertel carlyle	Stub
lewis cass	C
william rosenbaum	Stub
louis lausier	Start
kathy taylor	Start
elizabeth colbert busch	C
bidal aguero	C
shan tsutsui	C
samuel wadsworth gould	Start
maurice cunningham	C
mimi stewart	C
mary wendy roberts	C
unofficial organizations for democrats	Stub
littleton waller tazewell	C
patricia bailey	Stub
herschel lashkowitz	Stub
harold earthman	Start
democratic party of arkansas	C
samuel dickinson hubbard	Start
leroy percy	C
catherine cortez masto	C
scot kelsh	Stub
chet edwards	C
melody mccray-miller	Stub
mike caputo	Stub
holli woodings	Start
scott angelle	C
william hayden english	FA
george docking	Start
charles hodgdon	Stub
elesha gayman	Start
herb rozell	Stub
joe miklosi	C
augustus hill garland	C
fart proudly	Start
william thomas ellis	C
carolyn comitta	Start
rebecca cohn	Start
diane farrell	C
florida central voter file	C
michael mulrooney	Start
susan bonilla	Start
chuck hunter	Stub
paris gibson	Start
emma guy cromwell	C
paula sandoval	Start
brooks hays	C
charles couch	Stub
joyce elliott	Stub
vincent wetta	Stub
robert emmett bledsoe baylor	Start
katie hobbs	Start
jan graham	Start
james meriwether	Start
list of fictional united states democrats	B
mia ackerman	Stub
chet dobis	Stub
joe hogsett	C
leo mcgarry	B
bob angelle	Start
willem jewett	Stub
marie poulson	C
john goode	Start
herbert berman	Stub
lucius elmer	Start
walter bickford	Stub
james tokioka	Start
dennis deconcini	C
lindsey holmes	Stub
brad ashford	C
william henry hooper	Start
lewis williams douglas	C
united states federal building security	Start
treaty of dancing rabbit creek	C
william anderson handley	Stub
howard warren buffett	C
jessica haak	Stub
alvin baldus	Stub
jennifer gale	C
stephanie bolden	Start
sharon bulova	GA
charles oatley	Start
john weir troy	Stub
dan gelber	C
norman kittson	B
john taylor hamilton	B
anne healey	Stub
matt moonen	Stub
charles robin britt	Start
ted danson	GA
flavia colgan	Start
charles edison	C
henry carl luckey	Stub
ephraim king wilson	Stub
john henry caldwell	Start
kelley wirth	Start
marie redd	Stub
susana martinez	GA
john synowiecki	Stub
ken cheuvront	Start
william ellery sweet	Start
keith neville	Start
susan rice	GA
joe gallegos	Start
orestes cleveland	Start
pat harrison	GA
joseph weldon bailey	Start
david domina	B
dwight takamine	Start
elias carr	Start
george huddleston	Start
new democrats	GA
ossie brown	C
liberal party of new york	C
sarah silverman	GA
center for american progress	C
judi dutcher	Start
brandon shaffer	Start
nathaniel littlefield	Start
warren evans	Start
1832 democratic national convention	C
benjamin harvey hill	C
greg didonato	Start
jan laverty jones	Start
michael barbieri	Start
chester bowles	C
jacob golladay	Start
gabriel holmes	Stub
charles billinghurst	Start
karl frisch	Stub
jim ferrell	GA
maine democratic caucuses, 2004	Stub
penelope gross	Start
darcy burner	C
mark nakashima	Stub
francis baasen	Stub
james bouldin	Start
georgette berube	Start
john fonfara	Stub
curtis brantley	Stub
rose mofford	C
john carnevale	C
james michael curley	C
gary auerbach	Start
john brough	C
richard joseph davis	Start
anthony brindisi	Stub
bushwick democratic club house	C
alternet	C
virgil weigel	Stub
barbara lambert	Start
paul hubbert	Start
enoch kelly haney	C
larry valencia	Start
sharon denise dixon	Start
charles eaton haynes	Stub
patti julian	Stub
mark desaulnier	C
don bivens	Start
edward burd hubley	Stub
debra heffernan	Start
benjamin downing	Start
kevin lembo	C
william menahan	Stub
jerry mezzatesta	Start
stephen brewer	Start
connie ladenburg	Stub
hayes mcclerkin	C
ernest lister	Start
albert belan	Stub
democratic party presidential primaries, 1988	GA
oscar branch colquitt	B
william sellers	Start
shelley berkley	C
amos kendall	GA
henry toole clark	Start
kory kath	Start
lindel hume	Stub
jovan melton	Stub
staci appel	C
bob graham	C
conny varela	Start
hillary clinton presidential campaign, 2008	GA
francis ormand jonathan smith	Start
malia cohen	Start
rhonda fields	C
william henry brockenbrough	Stub
deborah ferguson	Stub
charlie crist	GA
joseph ackroyd	Stub
arthur seligman	Start
eddie bass	Start
jackie dingfelder	Start
george cabell	Start
elizabeth thomson	Start
pamela carter	Start
charles henry rose	Stub
hillary clinton	FA
frederick myron colby	Stub
julius sterling morton	C
mary gant	Stub
dan slater	Stub
rufus blodgett	Stub
maggie crotty	C
ronald noble	C
dick sadler	Stub
jorge elorza	GA
jim cooper	GA
steve sisolak	Start
thaddeus leavitt	B
1848 democratic national committee	Start
robert novak	GA
gus douglass	GA
leander babcock	Start
harriet smith windsor	Start
walter maddock	Start
diane bilyeu	Start
james black groome	Start
mark carron	Stub
byron white	C
wendy jaquet	Start
gary locke	C
joni gutierrez	Stub
ellis baker usher	Stub
jeane kirkpatrick	B
william fell giles	Start
william emmett dever	Start
mat erpelding	Start
patience latting	C
coleen seng	Start
roger cooper	Start
james sevier conway	Start
george robinson black	Start
alexander gilmore cochran	Stub
jan malik	C
peggy gibson	Start
robert leroy cochran	Start
carl edward bailey	C
aravind joshi	Start
billy wayne bailey	Stub
james mcclinton	Start
florence reville gibbs	Start
june ward gayle	Stub
steve tomac	Stub
democratic governors association	C
frank kelty	Start
jennifer brady	Stub
benjamin franklin, self-revealed	Stub
james henderson berry	Start
joe cimperman	C
tom calderon	Stub
gene hodges	Stub
dewitt clinton giddings	Start
rodger mcdaniel	Start
ralph waldo emerson gilbert	Start
democratic black caucus of florida	Stub
jerry ortiz y pino	Stub
charles floyd hatcher	Start
stephen warfield gambrill	Start
irv halter	Start
albert kocer	Stub
francis strother lyon	Start
1916 democratic national convention	Stub
william gupton	Stub
charles barron	B
straw polls for the democratic party presidential primaries, 2016	Start
bob herron	Start
james henry hoyt	Stub
william james bryan	C
greg barro	Start
carroll gartin	Start
george paget thomson	Start
joseph karth	Start
hillblazers	Start
democrats for life of america	B
gerard brandon	Start
byron de la beckwith	C
moses alexander	Start
noel byars	B
frank porter graham	C
fort mitchell historic site	C
larry clapp	Stub
francis preston blair	C
washington mclean	Start
lauren bacall	GA
al doty	C
treaty of new echota	C
beverley randolph mason	B
henry grider	Start
lisa simpson	FA
corey mock	C
hillaryland	Start
roy dyson	Start
john bratton	C
cory booker	GA
winston bryant	Start
dan jolly	Stub
john conness	Start
new mexico democratic caucuses, 2004	Stub
david carradine	GA
william willis garth	Stub
matt connealy	Start
thomas carmichael	C
gussie busch	C
diane denish	Start
bernie fowler	Start
henry hull carlton	Start
sekou biddle	C
quinten burg	Stub
john atkin	Stub
jeff berding	C
oklahoma city memorial marathon	Start
1936 democratic national convention	Start
david farabee	C
betsy markey	C
isaiah dixon	Stub
alpheus felch	Start
jeff merkley	GA
abram hewitt	C
mark takai	C
hank elliott	Stub
clay pell	Start
dick celeste	C
william benjamin craig	Stub
thomas stevenson drew	C
wooda nicholas carr	Stub
betty flores	C
isaac hill	C
tony avella	C
thomas patrick moore	Start
john archibald campbell	B
margaret rose henry	Start
jim davnie	Start
emmitt ford	Start
wallace dann	Start
rob nosse	Start
floyd prozanski	C
nadine winter	Start
mary beck	Start
brian taniguchi	C
james florio	C
archibald hunter arrington	Start
italo cappabianca	Start
edward everett cox	GA
tom facey	Stub
earl chudoff	Start
corydon beckwith	Stub
thomas denham	Start
william gordon mathews	Start
william hinson cole	Start
bernie buescher	Start
gail shibley	Start
ryan bizzarro	Stub
david hayes kincheloe	Start
sharon cissna	C
thomas james churchill	C
charles kilbury	Stub
william washington howes	Stub
daniel marcy	Stub
rodolphus dickinson	Start
zalmon wildman	Stub
gwen cherry	Start
jack conners	Start
orson scott card	GA
carol spackman moss	Start
michael bortner	Stub
the brooklyn rail	C
joshua herrick	Start
david brenerman	Stub
nick bruno	C
james baumann	Start
kenneth carter	Start
nate libby	Stub
alem marr	Stub
john groppo	Stub
teresa tanzi	Start
jerome ambro	Start
dave pethtel	Start
jim suttle	C
thomas palangio	Start
claude weaver	Start
joseph czerwinski	Stub
lawrence dicara	Start
social contributions and studies by benjamin franklin	Start
elliot werk	Start
norman eddy	Start
sue ramsey johnston ferguson	Stub
herb kirsh	Start
thelma buchholdt	Start
samuel mckean	Start
joel yancey	Stub
skip campbell	GA
elizabeth esty	C
richard perchlik	Start
gene stipe	Start
scott inman	Start
mary cheh	C
nancy peoples guthrie	Start
uvalde lindsey	Start
ted deutch	C
john pendleton king	Start
deborah markowitz	C
eugenio alvarez	Stub
jim graham	C
liberalism in the united states	B
donna christian-christensen	C
dixie bibb graves	Start
ralph hunter daughton	Start
matthew denver	Start
galen hollenbaugh	Stub
office of the president-elect	C
reva beck bosone	Start
william san bento	C
leo lemay	Start
steve allen	C
kenneth kauth	Stub
anne-marie mastraccio	Stub
albert brewer	C
david worth clark	C
duncan brown cooper	C
michael merrifield	Start
1952 democratic national convention	Start
reform democrat	Stub
jorge alberto ramos comas	Start
elizabeth pugsley hayward	Start
grant burgoyne	Start
william henry barnum	Start
suzan delbene	GA
earl hanley beshlin	Start
raymond bartlett stevens	Start
anthony hensley	Start
joyce corcoran	Stub
sydenham elnathan ancona	Start
keith olbermann	GA
gordon burke	Stub
edmund baker	Stub
patsy keever	C
taul bradford	Stub
jim dotzenrod	Stub
committee of 48	GA
alden partridge	GA
tom henry	C
andrew johnson	FA
marlene caride	Start
alaska democratic caucuses, 2008	C
robert byrd	C
steve bryles	Start
thomas flournoy foster	Start
paul douglas	C
foster campbell	C
marion biggs	Start
ingram stainback	Start
cathy breen	Stub
eugene caputo	Stub
john brademas	C
daisy elliott	Start
tilghman howard	Start
william chatalas	Stub
jackie cilley	Start
samuel hadden harper	Stub
amy sheldon	Stub
nile dillmore	Stub
gregory francis	Stub
phyllis rutledge	Stub
oscar altpeter	Start
adam satchell	Stub
wisconsin democratic primary, 2004	Start
ed pastor	C
don fuqua	Start
angelo errichetti	C
tom ivester	Start
willie hensley	Start
william harrell felton	C
della herbst	Stub
charles harrison brown	Start
american samoa democratic caucuses, 2008	Start
nathaniel claiborne	Start
benjamin nageak	Start
seaborn jones	Start
don wesely	Start
gretchen driskell	Start
thomas david nicholls	Stub
jon blair hunter	Start
baron hill	GA
dean conley	Stub
larry jent	Start
steve burrage	Start
samuel beakes	Start
bob hawks	Stub
edgar herschler	Start
samuel williams inge	Start
rodolpho martinez	Stub
caroline bright	Start
jari askins	C
sydenham benoni alexander	Start
percy bland	C
jacob augustus geissenhainer	Start
merwin coad	C
richard cranwell	C
the chicagoan	C
oklahoma democratic primary, 2004	Start
paul cuprowski	Stub
ross wilkins	Start
haskins montgomery	Stub
nathaniel albertson	Stub
jesse bankston	C
jim barone	Stub
stephanie chang	C
john edward lamb	Stub
howard dean	B
anna caballero	Start
clark gruening	Start
james trezvant	Start
glen gainer iii	C
david walters	Start
augustus octavius bacon	C
william mcwillie	Start
seymour cray	C
george elliott hagan	Start
alex alben	C
daryl justin finizio	Start
grover cleveland	FA
mike hatch	C
felix andries vening meinesz	C
lauro cavazos	Start
harvey milk lesbian, gay, bisexual, transgender democratic club	Start
randy leonard	C
joe henry cooper	Start
bill richardson	B
jeanne hulit	Start
jean king	Start
sandy garrett	Start
united states senate democratic conference secretary	Start
phyllis kahn	Start
cyrus bussey	Start
roy barnes	GA
chris romer	C
jonathan brewster bingham	C
rocky delgadillo	C
john cummins edwards	C
robert hilder	C
henry daniel	Stub
charles stark draper	C
rick weiland	C
kirsten dunst	GA
colleen callahan	C
jennifer veiga	C
nancy denson	Start
allan turner howe	Start
keith crisco	Start
mark wheatley	Start
stan blake	Stub
joab lawler	Stub
russell hoopingarner	Stub
william lee cazort	Start
sidney parham epes	Start
holmes alexander	Start
lucy baxley	C
gary hooser	C
john bryan grimes	Stub
christopher donelan	Stub
lucius augustus hardee	Start
toni harp	Start
charles dayan	Start
simeon eben baldwin	C
sharon wylie	Stub
stephen davenport	Stub
simon bolivar buckner	FA
joseph chesak	Start
joshua marquis	C
charles hillyer brand	Start
david campos	C
mike arcuri	C
craig ford	Start
john edward halsell	Stub
tom connally	GA
christopher columbus harris	Start
maryland democratic party	C
alton cianchette	Start
george earle chamberlain	C
rod blagojevich	GA
william bigler	Start
john domenick	Stub
joe biden presidential campaign, 2008	FA
norm wallman	Stub
george busbee	C
ricardo bordallo	C
john adair	FA
jim slattery	C
bill richardson presidential campaign, 2008	C
spencer coggs	C
simon bamberger	C
cherokee removal	C
lara larramendi blakely	Start
ellen anderson	Start
charles henry hardin	Start
tim valentine	Start
charles brantley aycock	C
beverly briley	Start
bill botzow	Stub
nancy keenan	Start
philip testerman	Stub
bill halter	C
dick durbin	C
mike oliverio	C
moritz becker	Start
jacob candelaria	Start
asa lovejoy	GA
donna jean christianson	Stub
ramona martinez	Start
robert macdonald ford	Start
donzella james	Stub
jabez lamar monroe curry	Start
beverly byron	Start
patrick farrelly	Start
tipper gore	GA
maryland democratic primary, 2004	Stub
bob tuke	Stub
mark anthony cooper	Start
david litvack	Stub
greg burdine	Start
xavier becerra	C
george clooney	GA
christine barber	Stub
mike erlandson	Start
anthony chiappone	C
jack arthurs	Stub
vicki lensing	Start
forrest baugher	Stub
davis hanson waite	C
diane hathaway	C
evelyn momsen hailey	Start
peter hardeman burnett	C
marvin davis	GA
ken jennings	GA
robert porter caldwell	Start
john hastert	Stub
shannon augare	Stub
zelotus cotton	Stub
elease evans	Start
clifford cleveland brooks	C
hyram copeland	Start
chris deschene	Start
don blandford	Start
the conscience of a liberal	Start
daniel garrison	Stub
sojourners	C
sean connors	Start
andrew bachhuber	Stub
sandra jeff	Stub
herb connolly	Start
jeff benedict	C
judah dana	Start
aimee belgard	C
joe hackney	C
rae peppers	Start
nullification crisis	FA
warren christopher	C
dianne byrum	Start
montana democratic primary, 2008	Start
don navinsky	Stub
kim bracey	Start
johnny ford	Start
bill abington	Stub
walter naylor davis	Start
pam byrnes	C
paul newman	C
joseph gist	Stub
shane broadway	Stub
maurice connolly	C
list of democratic party superdelegates, 2008	B
stacey plaskett	C
audrey gibson	C
augusta clark	C
carrollton road-carrollton segment	Stub
ken hodges	C
nelson doi	Start
james blanchard	C
barney jackson	Stub
greene washington caldwell	Start
bruce antone	Start
william lemke	Start
united states presidential election in iowa, 1992	C
david clopton	Start
shepard cary	Stub
christie bryant	Stub
sean gatewood	Stub
william henry dewitt	Stub
cindy evans	Start
timothy ray murray	C
chris carney	C
sam cann	Start
janet petersen	Start
raza bokhari	Stub
jackie biskupski	C
charlie baird	C
clift tsuji	Start
hanover county courthouse	Start
james la fayette cottrell	Stub
jenise may	Stub
julia carson	C
jean carnahan	Start
juan candelaria	Stub
1972 democratic national convention	B
richard henry lee	C
kevin aguiar	Stub
harry hines woodring	C
national memorial institute for the prevention of terrorism	C
gregg takayama	Stub
judith loganbill	Stub
john broden	Start
mark kuhn	Start
rosa gill	Stub
hale boggs	C
andrew romanoff	C
rob andrews	C
troy kelley	Stub
mattie daughtry	Stub
larry ceisler	Start
howell edmunds jackson	C
calhoun allen	C
elizabeth kee	Start
oren harris	Start
vivian davis figures	C
daniel inouye	C
phelps phelps	C
michael douglas	GA
tallulah bankhead	GA
john blades clarke	Start
william hodding carter, i	Start
stephanie schriock	Start
john capozzi	Start
tazewell ellett	Stub
frank gaines harris	Start
timothy davlin	C
franke wilmer	C
mark ericks	Stub
ashton dovell	Start
bill sheffield	Start
william cowper alexander	Start
elijah webb chastain	Start
cisco mcsorley	Stub
democratic nominees for governor of california	Start
gene jeffress	Start
dixie allen	Stub
james sheakley	Start
spud clements	Stub
henry backstrom	Stub
volusia error	Start
jeff clemens	C
bill mccamley	Stub
rebecca chavez-houck	Start
alexis herman	C
deborah eddy	Start
thomas beall davis	Stub
joseph czarnezki	Stub
froilan tenorio	C
tim kaine	GA
paul krugman	FA
bill tilghman	C
heidi swank	Stub
steven bradford	C
william grayson	C
roman prezioso	Start
carlos vizcarrondo	Start
bundy standoff	B
john brown gordon	C
polly baca	B
isaac wilbour	Start
frank fasi	C
william bross	Start
caddy mckeown	Stub
obama on my mind	Stub
bob kerrey	B
colorado democratic caucuses, 2008	C
henry persons	Start
biagio ciotto	Stub
sylvia mathews burwell	GA
joe dorman	GA
peter welch	C
gerald brady	Start
the party of death	Start
fred dubois	C
henry cianfrani	Start
raymond blanco	Start
jeremiah donovan	Start
william walaska	C
john donelson	Start
faye armitage	Start
harry heher	Start
abraham browning	Start
william allee	Stub
floyd fithian	C
maria cantwell	B
polly bergen	C
charles pearce coady	Start
gary condit	GA
priorities usa action	C
joel roberts poinsett	C
james dipaola	Start
joan buchanan	Start
louis bromfield	Start
john kowalko	Start
lisa benlon	Stub
robert milligan mclane	C
daniel laurens barringer	Start
greta goodwin	Start
marcos cruz molina	Stub
phil cates	C
rose mary hatem bonsack	Start
edward thomas branch	Start
battle of talladega	C
hugh lawson white hill	Start
charles browne	Stub
north dakota democratic-nonpartisan league party	GA
hearcel craig	Stub
james herbert jones	Start
dick magruder	B
statewide opinion polling for the april, may, and june democratic party presidential primaries, 2008	Start
benjamin franklin stringfellow	Stub
gene vuckovich	Stub
chair of rural outreach	Stub
richard carrillo	Start
emil loriks	Start
guam democratic territorial convention, 2008	Stub
bob coffin	Start
credell calhoun	Stub
pat mccarran	C
thomas chilton	Start
john wiley bryant	Stub
spoils system	C
meg burton cahill	Stub
minnie fisher cunningham	FA
bernie friedman	Stub
alan mollohan	C
samuel bonom	Stub
albert clinton horton	C
dianna schimek	Start
eliseo alcon	Start
mark brzezinski	Start
lois delmore	Stub
